Sentence	entity_1	json	split
Since this patient population is a major reservoir of MDRO, investigating their fecal resistomes to characterize and quantify fecal antimicrobial - resistance ( AR) genes is needed ( van Schaik, 2015).	antimicrobial,132,145,treatment	"[{""token"": ""antimicrobial"", ""start_span"": 132, ""end_span"": 145, ""type"": ""treatment""}]"	test
Determination of Alkylbenzene Utilization in hNRB Enrichments To the first set of microcosms a known volume of mesitylene ( 1, 3, 5 - trimethylbenzene) was added to the oil layer at the end of incubation period.	hNRB,45,49,treatment	"[{""token"": ""hNRB"", ""start_span"": 45, ""end_span"": 49, ""type"": ""treatment""}]"	test
DOC was concentrated from 20 L of Animas River water from the 32nd St. Bridge location using Agilent Bond Elute PPL columns ( Agilent Technologies, Santa Clara, CA, USA), methanol as the column eluent, and sterile deionized water as the final solvent.	DOC,0,3,treatment	"[{""token"": ""DOC"", ""start_span"": 0, ""end_span"": 3, ""type"": ""treatment""}]"	test
Blood ( serum lipid) analysis For triglycerides, cholesterol, LDL, and HDL levels, blood samples were taken prior to the start of the synbiotic supplementation and at one - month post - supplementation and submitted for serum lipid profile analysis.	synbiotic supplementation,134,159,treatment	"[{""token"": ""synbiotic supplementation"", ""start_span"": 134, ""end_span"": 159, ""type"": ""treatment""}]"	test
For intraperitoneal infection, mice were injected with ~ 20 L via insulin syringe ( 29 G needle) with undiluted virus into the peritoneal cavity.	undiluted virus,102,117,treatment	"[{""token"": ""undiluted virus"", ""start_span"": 102, ""end_span"": 117, ""type"": ""treatment""}]"	test
Samples were irradiated with a dose of 10 kGy.	irradiated with a dose of 10 kGy,13,45,treatment	"[{""token"": ""irradiated with a dose of 10 kGy"", ""start_span"": 13, ""end_span"": 45, ""type"": ""treatment""}]"	test
Materials and methods Reactors operation and sampling Anaerobic sludge was obtained from a well - performing anaerobic lab - scale CSTR reactor that had not been exposed to any antibiotics.	antibiotics,177,188,treatment	"[{""token"": ""antibiotics"", ""start_span"": 177, ""end_span"": 188, ""type"": ""treatment""}]"	test
Most animals consumed the entire daily volume of DSSwater for the treatment duration, however, some animals failed to ingest the prescribed dose and some animals consumed each dose more rapidly than others, which may be reflected in some of the animal - to - animal variability seen in our measures of colitis.	DSSwater,49,57,treatment	"[{""token"": ""DSSwater"", ""start_span"": 49, ""end_span"": 57, ""type"": ""treatment""}]"	test
In this cohort study, data and rectal samples were collected at baseline and every 3 months for up to 12 months or until subject death, and included demographics, cause of dementia, comorbidities, functional status, and antimicrobial exposures.	antimicrobial,220,233,treatment	"[{""token"": ""antimicrobial"", ""start_span"": 220, ""end_span"": 233, ""type"": ""treatment""}]"	test
Here we show that with 16 weeks of KD, mice had significant increases in CBF and P - glycoprotein transports on BBB to facilitate clearance of amyloid - beta, a hallmark of Alzheimers disease ( AD).	KD,35,37,treatment	"[{""token"": ""KD"", ""start_span"": 35, ""end_span"": 37, ""type"": ""treatment""}]"	test
ABX - treated water was sterile filtered prior to placement in mouse cages and provided to mice ad libitum.	ABX,0,3,treatment	"[{""token"": ""ABX"", ""start_span"": 0, ""end_span"": 3, ""type"": ""treatment""}]"	test
Upon eclosion, 10 adults carrying either mun + or mun - strains were dissected and their guts were plated onto non - selective MRS agar ( S4 Fig).	mun + or mun - strains,41,63,treatment	"[{""token"": ""mun + or mun - strains"", ""start_span"": 41, ""end_span"": 63, ""type"": ""treatment""}]"	test
To monitor reactor performance, mixed liquor and effluent samples were collected, filtered through a membrane filter ( Whatman, Maidstone, United Kingdom) ( 0. 45 - m pore size), and analyzed for acetate, PO43 - - P, NH3 plus NH4 + - N, NO3 - - N, and NO2 - - N.	acetate,196,203,treatment	"[{""token"": ""acetate"", ""start_span"": 196, ""end_span"": 203, ""type"": ""treatment""}]"	test
Metaproteomics Samples used for metaproteomics experiments were collected from in situ nylon bags containing 5g of air - dried switch grass or corn stover that were placed in the rumen of two cannulated cows ( designated Y and Z).	nylon bags containing 5g of air - dried switch grass or corn stover,87,154,treatment	"[{""token"": ""nylon bags containing 5g of air - dried switch grass or corn stover"", ""start_span"": 87, ""end_span"": 154, ""type"": ""treatment""}]"	test
The sandstone and lignite samples were preserved in sterile glass bottles under anaerobic conditions with filtered N2 gas, and stored at 4C in the dark prior to use in the shore - based laboratory.	N2 gas,115,121,treatment	"[{""token"": ""N2 gas"", ""start_span"": 115, ""end_span"": 121, ""type"": ""treatment""}]"	test
T - RFLP Primers targeting the glycoside hydrolase families 5 ( cel5 _ 392F 5 - GAG CAT GGG CTG GAA YHT NGG NAA - 3 and cel5 _ 754R 5 - CAT CAT AAT CTT TGA AGT GGT TTG CAA TYT GDK TCC A - 3) and 48 ( cel48 _ 490F 5 TNA TGG TTG AAG CTC CDG AYT AYG G - 3 and cel48 _ 920R 5 - CCA AAN CCR TAC CAG TTR TCA ACR TC - 3) [ 86] were used to study the cellulose - degrading bacterial community structures in the different inoculum samples and at the end of the batch test by terminal restriction fragment length polymorphism ( T - RFLP) analysis.	cellulose,343,352,treatment	"[{""token"": ""cellulose"", ""start_span"": 343, ""end_span"": 352, ""type"": ""treatment""}]"	test
In total, 12 RMs were used across the various groups in our DSS studies ( 6 RMs for SIV - uninfected acute colitis model, 2 RMs for SIV - uninfected chronic colitis model and MRI and 4 RMs for SIV - uninfected untreated controls).	DSS,60,63,treatment	"[{""token"": ""DSS"", ""start_span"": 60, ""end_span"": 63, ""type"": ""treatment""}]"	test
The retention time of the semicontinuous reactor was maintained at 6 days by pumping conversion residue into the reactor, pumping reactor effluent from the reactor once per hour, and maintaining a liquid volume of 150ml in the reactor.	conversion residue,85,103,treatment	"[{""token"": ""conversion residue"", ""start_span"": 85, ""end_span"": 103, ""type"": ""treatment""}]"	train
Initial partial pressure of CO in the headspace of the reactor was 0kPa.	CO,28,30,treatment	"[{""token"": ""CO"", ""start_span"": 28, ""end_span"": 30, ""type"": ""treatment""}]"	train
The rhizoplane with soil particles strongly attached to the root surface were sampled at anthesis for DNA extraction ( BBCH6569, reached on May 22, 2013 in both the ambient and elevated CO2 treatments).	ambient and elevated CO2,165,189,treatment	"[{""token"": ""ambient and elevated CO2"", ""start_span"": 165, ""end_span"": 189, ""type"": ""treatment""}]"	train
For scanning electron microscopic ( SEM) images, lignite particle and sponge samples were prefixed in 2. 5% ( w / v) glutaraldehyde in the anaerobic medium used for the DHS reactor cultivation without organic compounds.	anaerobic medium,139,155,treatment	"[{""token"": ""anaerobic medium"", ""start_span"": 139, ""end_span"": 155, ""type"": ""treatment""}]"	train
EC users vaped regularly throughout the day, used ECs daily, and had been actively using ECs for a median of three years.	EC,0,2,treatment	"[{""token"": ""EC"", ""start_span"": 0, ""end_span"": 2, ""type"": ""treatment""}]"	train
Both UASB reactors were filled with a methanogenic inoculum ( 1. 5L) and neutralized lactate - rich artificial medium ( 2L), and then incubated at room temperature ( 2025C).	methanogenic inoculum,38,59,treatment	"[{""token"": ""methanogenic inoculum"", ""start_span"": 38, ""end_span"": 59, ""type"": ""treatment""}]"	train
Here we employ a non - human primate model of chemically induced colitis in SIV - uninfected rhesus macaques that we developed using dextran sulfate sodium ( DSS), to directly test this hypothesis.	DSS,158,161,treatment	"[{""token"": ""DSS"", ""start_span"": 158, ""end_span"": 161, ""type"": ""treatment""}]"	train
Flour ( 5 kg) in paper bags was placed in a cardboard box and exposed to 60Co - ray source at Gammatom s. r. l.	60Co - ray,73,83,treatment	"[{""token"": ""60Co - ray"", ""start_span"": 73, ""end_span"": 83, ""type"": ""treatment""}]"	train
The master slurry and glass column were continuously flushed by N2 gas at all times.	N2,64,66,treatment	"[{""token"": ""N2"", ""start_span"": 64, ""end_span"": 66, ""type"": ""treatment""}]"	train
Furthermore, patients undergoing professional periodontal therapy during the 6months prior to baseline and patients with periodontal pockets 6mm in more than two sextants were excluded.	periodontal therapy,46,65,treatment	"[{""token"": ""periodontal therapy"", ""start_span"": 46, ""end_span"": 65, ""type"": ""treatment""}]"	train
To quantify stability in insects, mature larvae were mono - associated as described above with E. mundtii G2 carrying either pRK1 or pRK62, and returned to conventional grain - honey diet to complete larval and pupal development.	grain - honey diet,169,187,treatment	"[{""token"": ""grain - honey diet"", ""start_span"": 169, ""end_span"": 187, ""type"": ""treatment""}]"	train
Reads aligning to enterovirus D68 ( EV - D68) were automatically mapped using SURPI to the US / MO / 14 - 18947 genome ( GenBank accession KM851225. 1) for determination of percent genomic coverage achieved.	US / MO / 14 - 18947,91,111,treatment	"[{""token"": ""US / MO / 14 - 18947"", ""start_span"": 91, ""end_span"": 111, ""type"": ""treatment""}]"	train
Inclusion criteria for EC users included daily use of ECs for at least six months.	EC,23,25,treatment	"[{""token"": ""EC"", ""start_span"": 23, ""end_span"": 25, ""type"": ""treatment""}]"	train
Concentrations of toluene, ethylbenzene, o - xylene, and m / p - xylene in the oils were calculated based on the standard line obtained from the peak areas of pure individual standard alkylbenzenes ( SigmaAldrich) analyzed by GC - MS.	toluene,18,25,treatment	"[{""token"": ""toluene"", ""start_span"": 18, ""end_span"": 25, ""type"": ""treatment""}]"	train
The warming treatment simulates the predictions derived from six atmosphere general circulation models for the second half of the twenty - first century in the Western Mediterranean region ( De Castro et al., 2005), and was achieved by installing ventilated open - top chambers ( OTCs), which are hexagonal chambers with sloping slides of 40 cm x 50 cm x 32 cm ( Fig. S2).	warming,4,11,treatment	"[{""token"": ""warming"", ""start_span"": 4, ""end_span"": 11, ""type"": ""treatment""}]"	train
The TS and VS content measurements were modified in a way that a reactor sample was not added directly to a crucible, but only the pellet after centrifuging 100 mL reactor content ( 10, 000 g, 10 min, and 10C) to increase the amount of biomass per analysis and to reduce the potential error of VFAs in the sample.	VFAs,294,298,treatment	"[{""token"": ""VFAs"", ""start_span"": 294, ""end_span"": 298, ""type"": ""treatment""}]"	train
Bottles without hNRB inoculum were also prepared.	hNRB,16,20,treatment	"[{""token"": ""hNRB"", ""start_span"": 16, ""end_span"": 20, ""type"": ""treatment""}]"	train
All subjects of this study were under a Mediterranean - based diet, and no antibiotics, probiotics, or prebiotics have been taken in the 3months prior to the sample collection.	Mediterranean - based diet,40,66,treatment	"[{""token"": ""Mediterranean - based diet"", ""start_span"": 40, ""end_span"": 66, ""type"": ""treatment""}]"	train
We used a recently established rabbit model of dextran sodium sulphate ( DSS) induced colitis to study the efficacy, mechanisms and safety of TSO therapy in immunocompetent and immunosuppressed animals.	TSO,142,145,treatment	"[{""token"": ""TSO"", ""start_span"": 142, ""end_span"": 145, ""type"": ""treatment""}]"	train
The feed was replaced with fresh seawater every 3 d. After 4 weeks, the feed solution was replaced with 5 L of P. aeruginosa - enriched seawater.	fresh seawater,27,41,treatment	"[{""token"": ""fresh seawater"", ""start_span"": 27, ""end_span"": 41, ""type"": ""treatment""}]"	train
In the present study, we hypothesized that exposing laboratory mice to ABX in a manner similar to that of human children ( i. e. brief, but repeated, exposures) would increase the severity of house dust mite ( HDM) - induced allergic airway disease ( AAD) later in life.	ABX,71,74,treatment	"[{""token"": ""ABX"", ""start_span"": 71, ""end_span"": 74, ""type"": ""treatment""}]"	train
The data were expressed on a per plant basis, and results from the ambient and elevated CO2 treatments were compared with ttests in JMP 12. 0. 1 ( SAS Institute, USA).	ambient and elevated CO2,67,91,treatment	"[{""token"": ""ambient and elevated CO2"", ""start_span"": 67, ""end_span"": 91, ""type"": ""treatment""}]"	train
Three samples were mixed ( 50g of 1922 mbsf lignite, 10g of 1978 mbsf sandstone, and 50g of 1978 mbsf lignite) with 890ml anaerobic medium ( described below) without any organic substances.	anaerobic medium,122,138,treatment	"[{""token"": ""anaerobic medium"", ""start_span"": 122, ""end_span"": 138, ""type"": ""treatment""}]"	train
Within 7days the animals were supplemented with synbiotic therapy.	synbiotic therapy,48,65,treatment	"[{""token"": ""synbiotic therapy"", ""start_span"": 48, ""end_span"": 65, ""type"": ""treatment""}]"	train
Furthermore, in order to evaluate the influence of COLOSTRONONI treatment in gut microbiota composition of rats we have collected the faecal samples at three different time points before ( T0), during ( T1) and after ( T2) treatment ( Fig 1).	COLOSTRONONI,51,63,treatment	"[{""token"": ""COLOSTRONONI"", ""start_span"": 51, ""end_span"": 63, ""type"": ""treatment""}]"	train
The interdependent responses of plants and ectomycorrhizal fungi to warming and rainfall reduction may lead to a detrimental feedback loop on vegetation productivity and nutrient pool size, which could amplify the adverse impacts of forecasted climate change on ecosystem functioning in EMF - dominated drylands.	warming,68,75,treatment	"[{""token"": ""warming"", ""start_span"": 68, ""end_span"": 75, ""type"": ""treatment""}]"	train
The feed was mixed with mineral based medium which was previously described ( Plugge 2005; Stams et al. 1993), with additional 100mgL1 Fe2 ( SO4) 3 and omitting reducing agents to maintain a HRT of 20days throughout the experiment.	mineral based medium,24,44,treatment	"[{""token"": ""mineral based medium"", ""start_span"": 24, ""end_span"": 44, ""type"": ""treatment""}]"	train
Results Hypercholesterolemia and drug treatment analysis Hypercholesterolemia was confirmed at 5 weeks of HFD feeding by elevated serum cholesterol levels.	HFD,106,109,treatment	"[{""token"": ""HFD"", ""start_span"": 106, ""end_span"": 109, ""type"": ""treatment""}]"	train
Uninoculated tubes without nitrate were also prepared.	nitrate,27,34,treatment	"[{""token"": ""nitrate"", ""start_span"": 27, ""end_span"": 34, ""type"": ""treatment""}]"	train
The manganese oxide activity was 0, 10, 20, or 40 mM. All experiments were done in triplicates.	manganese oxide,4,19,treatment	"[{""token"": ""manganese oxide"", ""start_span"": 4, ""end_span"": 19, ""type"": ""treatment""}]"	train
Nucleic acid was extracted from 50 L of spinal cords lysate with the Direct - zol RNA Kit ( Zymo Research, Irvine, CA) or 50 L virus culture using the automated Qiagen EZ1 robotic instrument ( Qiagen, Valencia, CA), followed by treatment with Turbo DNase, then randomly reverse transcribed to cDNA with random hexamer primers.	virus,127,132,treatment	"[{""token"": ""virus"", ""start_span"": 127, ""end_span"": 132, ""type"": ""treatment""}]"	train
To all columns, 400 mL of sterile artificial sea water ( Kester et al., 1967; Berges et al., 2001) was added and allowed to drain by gravity flow and captured.	artificial sea water,34,54,treatment	"[{""token"": ""artificial sea water"", ""start_span"": 34, ""end_span"": 54, ""type"": ""treatment""}]"	train
On day 0 of the experience, we collected fecal samples from the all rats, and subsequently AIA treatment was instigated by a single subcutaneous injection of 0. 1 mL of complete Freund ' s adjuvant ( CFA) containing 0. 2 mg of Mycobacterium tuberculosis H37Ra ( BD, Sparks, USA) and mineral oils ( Sigma - Aldrich, Milwaukee, USA) into the root of rats ' tails [ 15].	mineral oils,283,295,treatment	"[{""token"": ""mineral oils"", ""start_span"": 283, ""end_span"": 295, ""type"": ""treatment""}]"	train
Duplicate serum bottles for all oils and all nitrate concentrations were incubated upside down at 30C for 90 days, while shaking at 80 rpm.	nitrate,45,52,treatment	"[{""token"": ""nitrate"", ""start_span"": 45, ""end_span"": 52, ""type"": ""treatment""}]"	train
Study design At baseline, clinical periodontal examinations were done and the blinded toothpastes were dispensed.	toothpastes,86,97,treatment	"[{""token"": ""toothpastes"", ""start_span"": 86, ""end_span"": 97, ""type"": ""treatment""}]"	train
All of the children in South Africa were vaccinated against pneumococcus using PCV - 7 according to the national vaccination schedule ( Madhi et al., 2012).	PCV - 7,79,86,treatment	"[{""token"": ""PCV - 7"", ""start_span"": 79, ""end_span"": 86, ""type"": ""treatment""}]"	train
This study focuses on metabolic transformation of lactate during the acetogenic and methanogenic steps of anaerobic digestion in methane - yielding bioreactors.	lactate,50,57,treatment	"[{""token"": ""lactate"", ""start_span"": 50, ""end_span"": 57, ""type"": ""treatment""}]"	train
Experimental design In the initial experiment, male SIRT3KO or WT littermates ( 8 weeks old) were subjected to dextran sulfate sodium ( DSS) - induced colitis by adding DSS ( MW 3640kDa, MP Biologicals) to drinking water at a 2. 5% weight volume for 6 days ( Supplementary Figure 1).	DSS,136,139,treatment	"[{""token"": ""DSS"", ""start_span"": 136, ""end_span"": 139, ""type"": ""treatment""}]"	train
We knocked down lysozyme expression using RNAi in insect hosts that were colonized by either E. mundtii strain G2 - mun +, which produces the broad - spectrum bacteriocin mundticin [ 34], or by E. mundtii strain G2 - mun -, which is unable to express the mundticin - encoding gene munA. To test the impact of these manipulations we cured the gut microbiota from final - instar larvae using antibiotics and re - inoculated these individuals with either E. mundtii G2 - mun + or G2 - mun -, and reared them on conventional non - sterile diet until pupation.	antibiotics,390,401,treatment	"[{""token"": ""antibiotics"", ""start_span"": 390, ""end_span"": 401, ""type"": ""treatment""}]"	train
Unless otherwise specified, virus infections were performed on two day - old mice.	virus,28,33,treatment	"[{""token"": ""virus"", ""start_span"": 28, ""end_span"": 33, ""type"": ""treatment""}]"	train
Participants should have not taken antibiotics between both samplings, and the amount of DNA extracted had to be sufficient for the proposed analyses [ 6].	antibiotics,35,46,treatment	"[{""token"": ""antibiotics"", ""start_span"": 35, ""end_span"": 46, ""type"": ""treatment""}]"	train
The objects were two methane - yielding microbial communities ( designated M1A and M1B) processing a lactate - rich medium in 3. 5 - L up - flow anaerobic sludge blanket ( UASB) bioreactors ( Table1).	lactate - rich medium,101,122,treatment	"[{""token"": ""lactate - rich medium"", ""start_span"": 101, ""end_span"": 122, ""type"": ""treatment""}]"	train
The HFD contained 3% cholesterol ( Sigma Aldrich Co., USA), 0. 2% cholic acid ( Sigma Aldrich Co., USA), 15% beef tallow, and 81. 8% normal chow.	HFD,4,7,treatment	"[{""token"": ""HFD"", ""start_span"": 4, ""end_span"": 7, ""type"": ""treatment""}]"	train
Given the vital role microbes play in anaerobic digestion, studies characterizing the anaerobic microbial communities in the presence of antibiotics are essential to determining the potential impacts on methane and volatile fatty acids ( VFA) production.	antibiotics,137,148,treatment	"[{""token"": ""antibiotics"", ""start_span"": 137, ""end_span"": 148, ""type"": ""treatment""}]"	train
The medium was purged by N2 gas and pH was adjusted to 7. 5.	N2 gas,25,31,treatment	"[{""token"": ""N2 gas"", ""start_span"": 25, ""end_span"": 31, ""type"": ""treatment""}]"	train
Incubations of Enriched Microbial Consortia at Different Manganese Oxide Activity Microcosms were prepared with the inoculum from the enriched birnessite - reducing culture ( transfer III).	birnessite,143,153,treatment	"[{""token"": ""birnessite"", ""start_span"": 143, ""end_span"": 153, ""type"": ""treatment""}]"	train
In addition, a group of AIA rats were fed a high - fat diet ( D12492).	high - fat diet,44,59,treatment	"[{""token"": ""high - fat diet"", ""start_span"": 44, ""end_span"": 59, ""type"": ""treatment""}]"	train
Then, the CO partial pressure in the headspace was raised gradually from 40% ( pCO = 6. 8104Pa) to 100% CO ( pCO = 1. 7105Pa) ( COP ( 7) to COP ( 12)).	CO,10,12,treatment	"[{""token"": ""CO"", ""start_span"": 10, ""end_span"": 12, ""type"": ""treatment""}]"	train
In the initial hours of the cycle, DO was below 0. 5mg / L due to intensive usage of oxygen for organics and ammonium oxidation but increased from the fourth hour of the cycle and stabilized at 6mg / L until the end of the cycle.	oxygen,85,91,treatment	"[{""token"": ""oxygen"", ""start_span"": 85, ""end_span"": 91, ""type"": ""treatment""}]"	train
Arthritis was induced by injection of CFA on day 0 after fecal sample collection; fecal samples were collected for five time points ( TP) on day 0 ( TP1), day 7 ( TP2), day 14 ( TP3), day 21 ( TP4), and day 30 ( TP5).	CFA,38,41,treatment	"[{""token"": ""CFA"", ""start_span"": 38, ""end_span"": 41, ""type"": ""treatment""}]"	train
The sludge ( 13. 5 g / L wet sludge) was incubated in a 500 ml batch reactor with anaerobic mineral medium ( pH = 7. 3) containing the following components: 5. 6 mM NH4Cl, 0. 1 mM CaCl2. 2H2O, 1. 8 mM KH2PO4, 2. 0 mM Na2HPO4, and 3. 3.	anaerobic mineral medium,82,106,treatment	"[{""token"": ""anaerobic mineral medium"", ""start_span"": 82, ""end_span"": 106, ""type"": ""treatment""}]"	train
Inclusion criteria for this study required that subjects from the SPREAD study had two or more consecutive rectal samples and were exposed to systemic antimicrobials.	antimicrobials,151,165,treatment	"[{""token"": ""antimicrobials"", ""start_span"": 151, ""end_span"": 165, ""type"": ""treatment""}]"	train
Seawater from Red Sea was fed into each reactor at a continuous rate of 5 mL per minute.	Seawater,0,8,treatment	"[{""token"": ""Seawater"", ""start_span"": 0, ""end_span"": 8, ""type"": ""treatment""}]"	train
The amount of added enzymes was expressed as milligrammes of protein per HA added to the reactors: 0. 6mg cellulase mgHAadded 1, 0. 075mg xylanase mgHAadded 1 and 0. 55mg endoglucanase mgHAadded 1 for P1 to P5, and the enzyme amount was reduced by half for P6.	HA,73,75,treatment	"[{""token"": ""HA"", ""start_span"": 73, ""end_span"": 75, ""type"": ""treatment""}]"	train
Experimental chickens and Salmonella used for challenge In all experiments, newly hatched male ISA Brown chicks were obtained from a local commercial hatchery on the day of hatching.	Salmonella,26,36,treatment	"[{""token"": ""Salmonella"", ""start_span"": 26, ""end_span"": 36, ""type"": ""treatment""}]"	train
Mature final - instar larvae were starved for 4 h before being transferred to sterile antibiotic - amended diet for 24 h. Removal of the microbiota was confirmed by dissecting and plating the guts of 30 randomly - chosen larvae onto TSA plates.	antibiotic - amended diet,86,111,treatment	"[{""token"": ""antibiotic - amended diet"", ""start_span"": 86, ""end_span"": 111, ""type"": ""treatment""}]"	train
Since 11th day of cultivationnon - neutralized medium supplied to the bioreactorSample collection for 16S rRNA profiling37th week of cultivation40th week of cultivationAnalyses performed on the samples collected from the UASB reactors shown in Table233rd40th week of cultivation35th40th week of cultivationSample collection for isotope analyses of fermentation gas44th50th week of cultivationaThe director of the Municipal Water and Sewage Enterprise in the capital city of Warsaw in Poland issued the permission to sample activated sludge and use it for scientific research Analytical methods The pH of the medium and the methanogenic effluents as well as the redox potential in the UASB reactor were measured using a standard pH meter ( ELMETRON model CP - 502) equipped with a combination ORP ( redox, mV) electrode - type ERPt - 13.	activated sludge,523,539,treatment	"[{""token"": ""activated sludge"", ""start_span"": 523, ""end_span"": 539, ""type"": ""treatment""}]"	train
Viral stock preparation All EV - D68 viral strains were obtained from the American Type Culture Collection ( ATCC) or from the California Department of Public Health ( courtesy of Shigeo Yagi).	EV - D68 viral strains,28,50,treatment	"[{""token"": ""EV - D68 viral strains"", ""start_span"": 28, ""end_span"": 50, ""type"": ""treatment""}]"	train
The antibiotic treatment was administered via drinking water and consisted of a mixture of 0. 2gL1 ampicillin, 0. 1gL1 vancomycin, 0. 2gL1 neomycin and 0. 2gL1 metronidazole.	antibiotic,4,14,treatment	"[{""token"": ""antibiotic"", ""start_span"": 4, ""end_span"": 14, ""type"": ""treatment""}]"	train
Sodium hydroxide addition in R1 and R3 was applied whenever the pH dropped below 6. 5.	Sodium hydroxide,0,16,treatment	"[{""token"": ""Sodium hydroxide"", ""start_span"": 0, ""end_span"": 16, ""type"": ""treatment""}]"	train
RNA extraction and 16S rRNA gene based high - throughput sequencing A 2 mL aliquot of the biofilm suspension ( as described in section Infection of Biofilm With Bacteriophages at Various Conditions) was utilized for RNA extraction.	Bacteriophages,161,175,treatment	"[{""token"": ""Bacteriophages"", ""start_span"": 161, ""end_span"": 175, ""type"": ""treatment""}]"	train
DSS - treated and two untreated controls underwent colonoscopy with collection of colonic biopsies to evaluate both the gross and histological extent of colitis.	DSS,0,3,treatment	"[{""token"": ""DSS"", ""start_span"": 0, ""end_span"": 3, ""type"": ""treatment""}]"	train
Alpha - amylase activity The alpha - amylase activity of the flour, before and after irradiation, was estimated through determination of the falling number.	irradiation,85,96,treatment	"[{""token"": ""irradiation"", ""start_span"": 85, ""end_span"": 96, ""type"": ""treatment""}]"	train
After the first 30days ( P0) of the reactor operation, HA addition and inhibition mitigation experiments were started when the methane production stabilised.	HA,55,57,treatment	"[{""token"": ""HA"", ""start_span"": 55, ""end_span"": 57, ""type"": ""treatment""}]"	train
Chicks in the experimental group were orally inoculated on day 1 of life with 100 l of Aviguard solution prepared according to the recommendations of the manufacturer.	Aviguard solution,87,104,treatment	"[{""token"": ""Aviguard solution"", ""start_span"": 87, ""end_span"": 104, ""type"": ""treatment""}]"	train
An equal volume of saline was injected into the reference groups.	saline,19,25,treatment	"[{""token"": ""saline"", ""start_span"": 19, ""end_span"": 25, ""type"": ""treatment""}]"	train
The bioreactor was fed with anaerobic digester filtrate obtained from the belt filter press of a local wastewater treatment plant ( CVWRF, Salt Lake City, UT, USA).	digester filtrate,38,55,treatment	"[{""token"": ""digester filtrate"", ""start_span"": 38, ""end_span"": 55, ""type"": ""treatment""}]"	train
Statistical analyses Repeated measures ANOVAs ( RM - ANOVAs) were used to evaluate the effects of the two experimental factors ( warming and rainfall reduction), time, and their interactions, on leaf gas exchange parameters ( A, gs, WUEi, PSII, Fv / Fm, E), leaf nutrients (% N,% P, Narea, Parea), leaf dry mass, LMA, 13C, shoot elongation during late spring, late / early spring growth ratio, and survival rate.	warming,129,136,treatment	"[{""token"": ""warming"", ""start_span"": 129, ""end_span"": 136, ""type"": ""treatment""}]"	train
An aliquot of culture CO ( 4) was pasteurized and used as inoculum to start the enrichment series COP ( x) ( where P stands for pasteurization; x stands for number of successive transfers).	CO,22,24,treatment	"[{""token"": ""CO"", ""start_span"": 22, ""end_span"": 24, ""type"": ""treatment""}]"	train
The TSO suspension or vehicle ( volume 15ml) was completely filled in a syringe and administered to the animal using a gastric tube ( i. e. Ruesch Katheter, CH14, REF 402101, Kernen, Germany).	TSO suspension,4,18,treatment	"[{""token"": ""TSO suspension"", ""start_span"": 4, ""end_span"": 18, ""type"": ""treatment""}]"	train
Study Record Form A specifically - designed Study Record Form recorded demographic data plus whether the dog was a Case or Control and the date of the most recent antecedent vaccination ( of any type).	vaccination,174,185,treatment	"[{""token"": ""vaccination"", ""start_span"": 174, ""end_span"": 185, ""type"": ""treatment""}]"	train
32 composite hollow - fiber membranes ( Mitsubishi Rayon, Model MHF 200TL) ( 1. 31cmmL1) were used to supply CO ( at 30. 4kPa) by diffusion directly to the liquid media.	CO,109,111,treatment	"[{""token"": ""CO"", ""start_span"": 109, ""end_span"": 111, ""type"": ""treatment""}]"	train
During the first week, animals continued to follow a normal chow diet but received daily oral administration of a 2% sucrose solution ( volume: 500l), in order to train them to drink spontaneously from a syringe.	normal chow diet,53,69,treatment	"[{""token"": ""normal chow diet"", ""start_span"": 53, ""end_span"": 69, ""type"": ""treatment""}]"	train
Recovery of Se0 Spheres After incubation of anaerobic sludge with selenite, solids were recovered by centrifugation ( 37, 000 g, 30 min at 4C).	selenite,66,74,treatment	"[{""token"": ""selenite"", ""start_span"": 66, ""end_span"": 74, ""type"": ""treatment""}]"	train
Resazurin was used as an O2 indicator at a concentration of 5105% ( wv1).	Resazurin,0,9,treatment	"[{""token"": ""Resazurin"", ""start_span"": 0, ""end_span"": 9, ""type"": ""treatment""}]"	train
Groups of three newly hatched chicks were inoculated with 107 CFU in 0. 1 ml of inoculum containing Parabacteroides johnsonii An42 ( phylum Bacteroidetes, GenBank access.	Parabacteroides johnsonii An42,100,130,treatment	"[{""token"": ""Parabacteroides johnsonii An42"", ""start_span"": 100, ""end_span"": 130, ""type"": ""treatment""}]"	train
Afterwards, grass silage was added to the feed ( 17t / d).	grass silage,12,24,treatment	"[{""token"": ""grass silage"", ""start_span"": 12, ""end_span"": 24, ""type"": ""treatment""}]"	train
Adult male CF57BL / 6J mice were maintained in a flexible plastic film gnotobiotic isolator and fed a nutritionally - sufficient standard diet ( B & K autoclavable chow # 7378000, Zeigler Bros Inc.) ad libitum.	nutritionally - sufficient standard diet,102,142,treatment	"[{""token"": ""nutritionally - sufficient standard diet"", ""start_span"": 102, ""end_span"": 142, ""type"": ""treatment""}]"	train
To design a consistent, defined base diet for all experimental diets, a nutritionally - replete mixture of individual amino acids was used in place of complete protein.	a nutritionally - replete mixture of individual amino acids,70,129,treatment	"[{""token"": ""a nutritionally - replete mixture of individual amino acids"", ""start_span"": 70, ""end_span"": 129, ""type"": ""treatment""}]"	train
CSBK medium was used to obtain a final volume of 35 ml.	CSBK medium,0,11,treatment	"[{""token"": ""CSBK medium"", ""start_span"": 0, ""end_span"": 11, ""type"": ""treatment""}]"	train
Serum bottles were incubated at 30C and shaken horizontally at 125rpm to increase CO dissolution.	CO,82,84,treatment	"[{""token"": ""CO"", ""start_span"": 82, ""end_span"": 84, ""type"": ""treatment""}]"	train
Animals bred naturally, and in the current study cohort ( Fig. 1) offspring were maintained on the same HFD as the dams ( via lactation) until weaning at 7months of age.	HFD,104,107,treatment	"[{""token"": ""HFD"", ""start_span"": 104, ""end_span"": 107, ""type"": ""treatment""}]"	train
CO was the sole carbon and energy source added ( 40%; pCO = 6. 8104Pa) in the next transfers ( COP ( 5) and COP ( 6)).	CO,0,2,treatment	"[{""token"": ""CO"", ""start_span"": 0, ""end_span"": 2, ""type"": ""treatment""}]"	train
Synthesis: Our findings highlight the vulnerability of both native plants and their symbiotic mycorrhizal fungi to climate warming and drying in semiarid shrublands, and point to the importance of a deeper understanding of plant - soil feedbacks to predict dryland vegetation responses to forecasted aridification.	warming,123,130,treatment	"[{""token"": ""warming"", ""start_span"": 123, ""end_span"": 130, ""type"": ""treatment""}]"	train
Thus, the NAD - dependent lactate dehydrogenase Ldh _ 2, FeS oxidoreductase GlpC, transcription factor GntR, EtfB, and LutC were identified in the vicinity of the analyzed genes and annotated.	lactate,26,33,treatment	"[{""token"": ""lactate"", ""start_span"": 26, ""end_span"": 33, ""type"": ""treatment""}]"	train
Then, each sourdough was propagated for 5 consecutive days, by one daily back - slopping step, using 90 g of flour ( IF in all the cases, except for the C dough), 45 g of fermented dough, and 45 g of sterile tap water.	IF,117,119,treatment	"[{""token"": ""IF"", ""start_span"": 117, ""end_span"": 119, ""type"": ""treatment""}]"	train
We explored the immunologic mechanisms behind this association using a mouse model of house dust mite ( HDM) - induced asthma and early - life ABX exposure.	ABX,143,146,treatment	"[{""token"": ""ABX"", ""start_span"": 143, ""end_span"": 146, ""type"": ""treatment""}]"	train
Mainly the transcriptome of lamina propria mononuclear cells ( LPMC) was affected by TSO treatment, showing dampened innate and adaptive inflammatory responses.	TSO,85,88,treatment	"[{""token"": ""TSO"", ""start_span"": 85, ""end_span"": 88, ""type"": ""treatment""}]"	train
For intramuscular infection, mice were injected with ~ 20 L via insulin syringe ( 29 G needle) with undiluted virus into the medial aspect of the left hindlimb.	undiluted virus,100,115,treatment	"[{""token"": ""undiluted virus"", ""start_span"": 100, ""end_span"": 115, ""type"": ""treatment""}]"	train
To a second set of microcosms, additional toluene ( 71. 2570 mM) was added to 1 ml of oil phase in bottles that showed less than 5 mM reduction of nitrate after 90 days of incubation.	nitrate,147,154,treatment	"[{""token"": ""nitrate"", ""start_span"": 147, ""end_span"": 154, ""type"": ""treatment""}]"	train
During the microaerobic stage, an on / off control system was used to limit the amount of oxygen pumped to the reactor ( 0. 02liters / min) and to maintain microaerobic conditions in the mixed liquor ( DO set point = 0. 2mg / liter).	oxygen,90,96,treatment	"[{""token"": ""oxygen"", ""start_span"": 90, ""end_span"": 96, ""type"": ""treatment""}]"	train
Around 18months of age a small group of juveniles ( n = 7) were noted to have loose stools of unknown origin and supplementation with a synbiotic was initiated within a week of symptom onset.	synbiotic,136,145,treatment	"[{""token"": ""synbiotic"", ""start_span"": 136, ""end_span"": 145, ""type"": ""treatment""}]"	train
The Philippines had not implemented a national vaccination program against pneumococcus so half the children were randomly assigned to receive the PCV - 10 vaccine ( Rodenburg et al., 2010) vaccine.	PCV - 10 vaccine,147,163,treatment	"[{""token"": ""PCV - 10 vaccine"", ""start_span"": 147, ""end_span"": 163, ""type"": ""treatment""}]"	train
The CO delivery rate was 120. 5molh1, estimated from the amounts of measured end - products.	CO,4,6,treatment	"[{""token"": ""CO"", ""start_span"": 4, ""end_span"": 6, ""type"": ""treatment""}]"	train
We also asked questions about diet in general terms, such as whether dry ( kibble), wet ( canned) or home - cooked food was provided but did not request details.	diet,30,34,treatment	"[{""token"": ""diet"", ""start_span"": 30, ""end_span"": 34, ""type"": ""treatment""}]"	train
RNAi efficacy was monitored throughout the larval - pupal molt by performing relative qPCR on cDNA derived from dissected guts using the primers Gm _ Lys _ qPCR _ F1 ( 5 ' - ACTTTTACGAGATGCGGACTG - 3 ') and Gm _ Lys _ qPCR _ R1 ( 5 ' - TCTCATTCTCAACAAGGCACAC - 3 '), which target a region upstream of the region chosen as template for dsRNA synthesis, as well as S7e _ forward and S7e _ reverse which target the gene encoding ribosomal protein S7e [ 55], which was analyzed as a reference.	dsRNA,335,340,treatment	"[{""token"": ""dsRNA"", ""start_span"": 335, ""end_span"": 340, ""type"": ""treatment""}]"	train
These neurovascular enhancements were associated with reduced mechanistic target of rapamycin ( mTOR) and increased endothelial nitric oxide synthase ( eNOS) protein expressions.	neurovascular enhancements,6,32,treatment	"[{""token"": ""neurovascular enhancements"", ""start_span"": 6, ""end_span"": 32, ""type"": ""treatment""}]"	train
CaCl2 ( Sigma - Aldrich) was added to R3 and R5; 0. 11g CaCl2g HAadded 1 was supplied within different periods ( P1, P2, P3, P4 and P5).	CaCl2,0,5,treatment	"[{""token"": ""CaCl2"", ""start_span"": 0, ""end_span"": 5, ""type"": ""treatment""}]"	train
Four days prior to gavage of the defined 92 - strain culture collection, all mice were transitioned to the nutritionally - sufficient experimental diet.	nutritionally - sufficient experimental diet,107,151,treatment	"[{""token"": ""nutritionally - sufficient experimental diet"", ""start_span"": 107, ""end_span"": 151, ""type"": ""treatment""}]"	train
EC7 had a comparable carbon monoxide ( CO) ppm to other EC users and controls.	EC,0,2,treatment	"[{""token"": ""EC"", ""start_span"": 0, ""end_span"": 2, ""type"": ""treatment""}]"	train
Incubations without antibiotics were also performed.	without antibiotics,12,31,treatment	"[{""token"": ""without antibiotics"", ""start_span"": 12, ""end_span"": 31, ""type"": ""treatment""}]"	train
Patient Population and Sample Collection Patient data and rectal samples were obtained from The Study of Pathogen and Antimicrobial Use in Dementia ( SPREAD), a prospective cohort of 362 residents with advanced dementia in 35 nursing homes from the Boston, Massachusetts area, which quantified antimicrobial prescribing patterns for suspected infections and the acquisition of MDRO ( Mitchell et al., 2014).	antimicrobial,294,307,treatment	"[{""token"": ""antimicrobial"", ""start_span"": 294, ""end_span"": 307, ""type"": ""treatment""}]"	train
The reactor was operated under conditions of alternating anaerobic and low - oxygen 8 - h cycles.	oxygen,77,83,treatment	"[{""token"": ""oxygen"", ""start_span"": 77, ""end_span"": 83, ""type"": ""treatment""}]"	train
Modeling of the experimental setup Software simulations of the single and two - stage reactors were carried out using the complex anaerobic digestion simulation suite ( BioModel) developed by Angelidaki and co - workers [ 33, 34], which was later extended to account for biogas upgrading experiments with hydrogen injection [ 35].	hydrogen,305,313,treatment	"[{""token"": ""hydrogen"", ""start_span"": 305, ""end_span"": 313, ""type"": ""treatment""}]"	train
A control without bacteriophage inoculation was prepared for each temperature and pH condition.	bacteriophage,18,31,treatment	"[{""token"": ""bacteriophage"", ""start_span"": 18, ""end_span"": 31, ""type"": ""treatment""}]"	train
Response of the rhizosphere prokaryotic community of barley ( Hordeum vulgare L.) to elevated atmospheric CO2 concentration in opentop chambers Abstract The effect of elevated atmospheric CO 2 concentration [ CO 2] on the diversity and composition of the prokaryotic community inhabiting the rhizosphere of winter barley ( Hordeum vulgare L.) was investigated in a field experiment, using opentop chambers.	CO2,106,109,treatment	"[{""token"": ""CO2"", ""start_span"": 106, ""end_span"": 109, ""type"": ""treatment""}]"	train
Accordingly, we adjusted for feeding method ( exclusively breastfed, combination fed, exclusively formula fed), maternal BMI ( continuous), parity ( continuous), and batch and performed a sensitivity analysis in exclusively breastfed infants.	formula,98,105,treatment	"[{""token"": ""formula"", ""start_span"": 98, ""end_span"": 105, ""type"": ""treatment""}]"	train
Carbon monoxide was used as the sole energy and carbon source and added to the bottles headspace to the desired final partial pressure using a syringe.	Carbon monoxide,0,15,treatment	"[{""token"": ""Carbon monoxide"", ""start_span"": 0, ""end_span"": 15, ""type"": ""treatment""}]"	train
Each bacteriophage was then used individually to infect attached biofilm on the membrane at four different temperatures ( 25, 30, 37, and 45C) and pH values ( 5, 6, 7, 8) for 10 h at constant shaking of 200 rpm.	bacteriophage,5,18,treatment	"[{""token"": ""bacteriophage"", ""start_span"": 5, ""end_span"": 18, ""type"": ""treatment""}]"	train
Total ammonia ( NH3 plus NH4 +) concentrations were analyzed using the salicylate method ( method 10031; Hach Company, Loveland, CO).	ammonia,6,13,treatment	"[{""token"": ""ammonia"", ""start_span"": 6, ""end_span"": 13, ""type"": ""treatment""}]"	train
Samples were assigned into one of the three categories based on the time of collection: Treatment if the sample was collected during a pulmonary exacerbation ( as defined by Fuchs et al. [ 8]) and after any intravenous antibiotics were administered; Intermediate if the sample was collected in the month prior to or following a pulmonary exacerbation; Stable otherwise.	intravenous antibiotics,207,230,treatment	"[{""token"": ""intravenous antibiotics"", ""start_span"": 207, ""end_span"": 230, ""type"": ""treatment""}]"	train
Humic acid ( Sigma - Aldrich; CAS number 68131 - 04 - 4) addition was initiated, starting from day 30 for four reactors ( R2, R3, R4 and R5), while R1 was used as a control reactor.	Humic acid,0,10,treatment	"[{""token"": ""Humic acid"", ""start_span"": 0, ""end_span"": 10, ""type"": ""treatment""}]"	train
Additionally, samples were collected from the healthy, age and dietary matched, offspring at separate time points: 15months of age ( anal and stool swabs) and during a HFD challenge ( anal swabs, 2527months old; Fig. 1, Additionalfile2: Table S1).	HFD,168,171,treatment	"[{""token"": ""HFD"", ""start_span"": 168, ""end_span"": 171, ""type"": ""treatment""}]"	train
Colitis induction and clinical evaluation DSS Colitis was induced at day 26 as described previously25.	DSS,42,45,treatment	"[{""token"": ""DSS"", ""start_span"": 42, ""end_span"": 45, ""type"": ""treatment""}]"	train
Insect rearing G. mellonella larvae were reared in the dark at 30C on a grain - honey diet described previously [ 29].	grain - honey diet,72,90,treatment	"[{""token"": ""grain - honey diet"", ""start_span"": 72, ""end_span"": 90, ""type"": ""treatment""}]"	train
This was achieved by chick inoculation with Aviguard, commercially available competitive exclusion product containing the normal gut microbiota from specific pathogen - free chickens ( Lallemand, France) or by bacterial washes from WCHA ( Wilkins - Chalgren Agar) and YCFA ( Yeast extract, Casitone and Fatty Acid agar) agars obtained by anaerobic culture of serially diluted caecal samples from an adult hen.	Aviguard,44,52,treatment	"[{""token"": ""Aviguard"", ""start_span"": 44, ""end_span"": 52, ""type"": ""treatment""}]"	train
Upon receipt, pups were weaned and ABX treatment initiated.	ABX,35,38,treatment	"[{""token"": ""ABX"", ""start_span"": 35, ""end_span"": 38, ""type"": ""treatment""}]"	train
Aliquots ( 10 g) of the C and C - IF doughs were collected after the first fermentation, stored ( at 80C) in 10 ml of RNAlater diluted ( 1: 1) with water, and analyzed by culture - independent method ( 16S metagenetics).	IF,34,36,treatment	"[{""token"": ""IF"", ""start_span"": 34, ""end_span"": 36, ""type"": ""treatment""}]"	train
A negative control microcosm for each sediment sample did not receive additional DOC.	DOC,81,84,treatment	"[{""token"": ""DOC"", ""start_span"": 81, ""end_span"": 84, ""type"": ""treatment""}]"	train
After quality filtered, a total of 20887 and 18787 reads ( Table S1) were obtained for the inoculum and selenite reducing granules, respectively.	selenite,104,112,treatment	"[{""token"": ""selenite"", ""start_span"": 104, ""end_span"": 112, ""type"": ""treatment""}]"	train
Enrichment of Manganese Reducing Microbial Consortia From Activated Sludge To obtain a manganese oxide - reducing microbial consortium, returned activated sludge from a local waste water treatment plant ( Bonnybrook Wastewater Treatment Plant, Calgary, AB, Canada), was used as the inoculum.	manganese oxide,87,102,treatment	"[{""token"": ""manganese oxide"", ""start_span"": 87, ""end_span"": 102, ""type"": ""treatment""}]"	train
DNA extraction and amplification Five millilitres of wellhomogenized MOBB sludge, CO ( x) and COP ( x) cultures was stored at 20C.	CO,82,84,treatment	"[{""token"": ""CO"", ""start_span"": 82, ""end_span"": 84, ""type"": ""treatment""}]"	train
After 10 h of phage infection, biofilm was sonicated in 3. 5 mL of 1 PBS and analyzed based on procedures as described in sections P. aeruginosa Colony and Bacteriophage Plaque Counts on Membranes and RNA Extraction and 16S rRNA Gene Based High - Throughput Sequencing.	phage infection,14,29,treatment	"[{""token"": ""phage infection"", ""start_span"": 14, ""end_span"": 29, ""type"": ""treatment""}]"	train
Around 27months of age, and post - supplementation, juveniles were challenged with a HFD for 36days.	HFD,85,88,treatment	"[{""token"": ""HFD"", ""start_span"": 85, ""end_span"": 88, ""type"": ""treatment""}]"	train
For passive transfer experiments, 100 L of pooled sera was given by intraperitoneal injection via insulin syringe on post - natal day 1 to mice randomized between two litters.	pooled sera,43,54,treatment	"[{""token"": ""pooled sera"", ""start_span"": 43, ""end_span"": 54, ""type"": ""treatment""}]"	train
Preventive Trichuris suis ova ( TSO) treatment protects immunocompetent rabbits from DSS colitis but may be detrimental under conditions of immunosuppression Trichuris suis ova ( TSO) have been tested for therapeutic application in inflammatory bowel diseases ( IBD) yet understanding of the underlying mechanisms and safety in an immunocompromised host is limited due to lack of a suitable animal model.	DSS,85,88,treatment	"[{""token"": ""DSS"", ""start_span"": 85, ""end_span"": 88, ""type"": ""treatment""}]"	train
Hydrolysate was fermented with Saccharomyces cerevisiae Y128, a strain with improved xylose utilization ( 39).	Saccharomyces cerevisiae Y128,31,60,treatment	"[{""token"": ""Saccharomyces cerevisiae Y128"", ""start_span"": 31, ""end_span"": 60, ""type"": ""treatment""}]"	train
Animals were fasted overnight prior to TSO administration and sedated with 0. 4ml Hypnorm ( VetaPharma, Leeds, UK), s. c.	TSO,39,42,treatment	"[{""token"": ""TSO"", ""start_span"": 39, ""end_span"": 42, ""type"": ""treatment""}]"	train
The cathode was fed an oxygen - saturated inorganic solution ( see Supplementary methods).	oxygen - saturated inorganic solution,23,60,treatment	"[{""token"": ""oxygen - saturated inorganic solution"", ""start_span"": 23, ""end_span"": 60, ""type"": ""treatment""}]"	train
Hypercholesterolemia was confirmed after 5 weeks of the HFD treatment.	HFD,56,59,treatment	"[{""token"": ""HFD"", ""start_span"": 56, ""end_span"": 59, ""type"": ""treatment""}]"	train
Two juvenile cohorts that were untreated, healthy, age and dietary exposure matched were used for comparative analyses, including one sample set corresponding to the pre - supplementation time point ( n = 3, two males and one female, 15months old) and another sample set during a HFD challenge time point ( n = 4, all females, 2527months old).	HFD,280,283,treatment	"[{""token"": ""HFD"", ""start_span"": 280, ""end_span"": 283, ""type"": ""treatment""}]"	train
The first reactor served as control with no TC - HCl added.	TC - HCl,44,52,treatment	"[{""token"": ""TC - HCl"", ""start_span"": 44, ""end_span"": 52, ""type"": ""treatment""}]"	train
N 8 Age ( years), mean ( SD) 72 ( 7) Male, n (%) 8 ( 100) Smoking ( pack - year), median ( IQR) 67 ( 32110) FEV1 post - BD (% predicted), mean ( SD) 37 ( 8) Inhaled corticosteroid treatment, n (%) 8 ( 100) Positive cultures in stability 7 ( 87. 5) Microorganisms isolated - Haemophilus influenzae 3 ( 37. 5) - Pseudomonas aeruginosa 3 ( 37. 5) - Moraxella catarrhalis 2 ( 25) - Streptococcus pneumoniae 1 ( 12. 5) - Alcaligenes spp.	Inhaled corticosteroid,157,179,treatment	"[{""token"": ""Inhaled corticosteroid"", ""start_span"": 157, ""end_span"": 179, ""type"": ""treatment""}]"	train
Five days later, the first substrate ( corn silage) was fed into the fermenter, this is day 1 in the subsequent analysis.	corn silage,39,50,treatment	"[{""token"": ""corn silage"", ""start_span"": 39, ""end_span"": 50, ""type"": ""treatment""}]"	train
The experiment was divided in two phases: phase I, when the reactors were fed exclusively with cheese whey permeate and cheese waste powder, and phase II, when exogenous H2 was added to the reactors ( Fig. 1).	H2,170,172,treatment	"[{""token"": ""H2"", ""start_span"": 170, ""end_span"": 172, ""type"": ""treatment""}]"	train
The bottles running with steam - exploded birch with applied bioaugmentation ( pretreated + 215% v / v) received the same amount of steam - exploded material and inoculum, and different volumes of C. bescii culture, corresponding to 2, 5, 10, and 15% v / v of the volume of the inoculum.	bioaugmentation,61,76,treatment	"[{""token"": ""bioaugmentation"", ""start_span"": 61, ""end_span"": 76, ""type"": ""treatment""}]"	train
The linear length of the colon analysed for SIV - uninfected control RMs was on average 64. 5mm ( s. e. m. = 12. 2), for SIV - uninfected DSS - treated RMs was 74. 5mm ( s. e. m. = 17. 2) and for chronic SIV - infected RMs was 170. 9mm ( s. e. m. = 28. 3).	DSS,138,141,treatment	"[{""token"": ""DSS"", ""start_span"": 138, ""end_span"": 141, ""type"": ""treatment""}]"	train
All reactors were inoculated with crushed anaerobic granular sludge which was taken from a full - scale up - flow anaerobic sludge bed ( UASB) reactor, treating pulp and paper industry effluents ( Industriewater Eerbeek, Eerbeek, The Netherlands).	pulp and paper industry effluents,161,194,treatment	"[{""token"": ""pulp and paper industry effluents"", ""start_span"": 161, ""end_span"": 194, ""type"": ""treatment""}]"	train
Inclusion criteria for tobacco smokers included an Fagerstrom test for nicotine dependence 4 and smoked a minimum of 10 cigarettes per day.	tobacco,23,30,treatment	"[{""token"": ""tobacco"", ""start_span"": 23, ""end_span"": 30, ""type"": ""treatment""}]"	train
For the first 100days, the plant was fed exclusively with corn silage at ca.	corn silage,58,69,treatment	"[{""token"": ""corn silage"", ""start_span"": 58, ""end_span"": 69, ""type"": ""treatment""}]"	train
For intranasal infection, a total of 40 L of undiluted virus was micro - pipetted onto the noses of a post - natal day 2 pups in two boluses of 20 L with a 30 - minute interval between exposures.	undiluted virus,45,60,treatment	"[{""token"": ""undiluted virus"", ""start_span"": 45, ""end_span"": 60, ""type"": ""treatment""}]"	train
Samples were taken with sterile paper points ( ISO45, Roeko Dental, Langenau, Germany) at each visit ( baseline, 4weeks, 12weeks) at the same sampling sites before performing mechanical therapy.	mechanical therapy,175,193,treatment	"[{""token"": ""mechanical therapy"", ""start_span"": 175, ""end_span"": 193, ""type"": ""treatment""}]"	train
Immunosuppression Immunosuppressive treatment was started 2 weeks prior to the first TSO gavage.	TSO,85,88,treatment	"[{""token"": ""TSO"", ""start_span"": 85, ""end_span"": 88, ""type"": ""treatment""}]"	train
In addition, serial dilutions of irradiated flour ( IF) were maintained in a water bath at 80C for 15 min to activate spores, plated in Plate Count agar and incubated at 30C ( under aerobic or anaerobic conditions) for up to 76 h ( Aziz et al., 2006).	IF,52,54,treatment	"[{""token"": ""IF"", ""start_span"": 52, ""end_span"": 54, ""type"": ""treatment""}]"	train
The medium was autoclaved, left to cool, then NaHCO3, autoclaved separately, was added to a final concentration of 1. 14 g L - 1.	NaHCO3,46,52,treatment	"[{""token"": ""NaHCO3"", ""start_span"": 46, ""end_span"": 52, ""type"": ""treatment""}]"	train
The effect of COLOSTRONONI on the body weight ( BW), as well as on Food Intake ( FI) of the animals was recorded ( Fig 1).	COLOSTRONONI,14,26,treatment	"[{""token"": ""COLOSTRONONI"", ""start_span"": 14, ""end_span"": 26, ""type"": ""treatment""}]"	train
In order to knockdown lysozyme GALME expression, 500 ng of purified dsRNA was injected into the hemocoel of mature final - instar larvae.	dsRNA,68,73,treatment	"[{""token"": ""dsRNA"", ""start_span"": 68, ""end_span"": 73, ""type"": ""treatment""}]"	train
We also observed that KD reduced blood glucose levels and body weight, and increased blood ketone levels, which might be associated with gut microbiome alteration.	KD,22,24,treatment	"[{""token"": ""KD"", ""start_span"": 22, ""end_span"": 24, ""type"": ""treatment""}]"	train
Nasopharyngeal sample collection and enrichment protocol Sampling was performed according to each infant ' s scheduled visits: at birth ( within 6 h), at the time of their first PCV vaccination ( usually 6 weeks old), at the time of their second dose ( usually at 14 weeks old), at the time of the last dose ( 40 weeks old), and at 12 months.	first PCV vaccination,172,193,treatment	"[{""token"": ""first PCV vaccination"", ""start_span"": 172, ""end_span"": 193, ""type"": ""treatment""}]"	train
Cultures were monitored by measuring CO depletion and methane, hydrogen and acetate production.	CO,37,39,treatment	"[{""token"": ""CO"", ""start_span"": 37, ""end_span"": 39, ""type"": ""treatment""}]"	train
All patients were advised to keep brushing their teeth exclusively with the originally provided toothpaste.	toothpaste,96,106,treatment	"[{""token"": ""toothpaste"", ""start_span"": 96, ""end_span"": 106, ""type"": ""treatment""}]"	train
In this study, L. garvieae was selected as a probiotic strain because Lactococcus was present in at least 85% of all the samples with a relative abundance of 0. 14 0. 39%, and L. garvieae has been identified as a biological control agent in bullfrogs ( Mendoza et al., 2012).	probiotic,45,54,treatment	"[{""token"": ""probiotic"", ""start_span"": 45, ""end_span"": 54, ""type"": ""treatment""}]"	train
Clinical variables and sputum collection Spontaneous sputum was collected from each patient in clinical stability, and during the subsequent exacerbation before the administration of antibiotic therapy.	antibiotic,183,193,treatment	"[{""token"": ""antibiotic"", ""start_span"": 183, ""end_span"": 193, ""type"": ""treatment""}]"	train
The culture obtained after transfer III was used in further experiments to test how varied manganese oxide activity affects fermentation, metal reduction, and community composition.	manganese oxide,91,106,treatment	"[{""token"": ""manganese oxide"", ""start_span"": 91, ""end_span"": 106, ""type"": ""treatment""}]"	train
To associate larvae with a specific bacterial strain, sterile diet ( without antibiotics) was amended with an aliquot of an overnight culture to a final concentration of 103 CFU ml - 1.	bacterial strain,36,52,treatment	"[{""token"": ""bacterial strain"", ""start_span"": 36, ""end_span"": 52, ""type"": ""treatment""}]"	train
On day 50 ( denoted by the asterisk) of the 75 - day synbiotic supplementation period the majority juveniles stools ( n = 5) were observed to return to normal.	synbiotic supplementation,53,78,treatment	"[{""token"": ""synbiotic supplementation"", ""start_span"": 53, ""end_span"": 78, ""type"": ""treatment""}]"	train
Hoffman ' s tobacco hornworm diet was used to manipulate the G. mellonella gut microbiota.	Hoffman ' s tobacco hornworm diet,0,33,treatment	"[{""token"": ""Hoffman ' s tobacco hornworm diet"", ""start_span"": 0, ""end_span"": 33, ""type"": ""treatment""}]"	train
The H2 gas was provided in the reactors R1 and R2 by using a peristaltic pump operating at a flow rate of 1. 7mL / min and was injected through Al2O3 ceramic membranes having pore size of 1. 2m.	H2 gas,4,10,treatment	"[{""token"": ""H2 gas"", ""start_span"": 4, ""end_span"": 10, ""type"": ""treatment""}]"	train
