Sentence	entity_1	json	split
Tunicamycin - treatment resulted in 75 - 90% inhibition in [ 3H] mannose incorporation but only 20 - 25% inhibition in [ 3H] thymidine and [ 3H] leucine incorporation.	Tunicamycin,0,11,Chemical	"[{""token"": ""Tunicamycin"", ""start_span"": 0, ""end_span"": 11, ""type"": ""Chemical""}]"	train
A marked coronary angiogenesis is known to occur with chronic bradycardia.	coronary,9,17,Multi	"[{""token"": ""coronary"", ""start_span"": 9, ""end_span"": 17, ""type"": ""Multi""}]"	train
Heart rate decreased by 32% for 20 to 40 minutes after injection and was chronically reduced by 10%, 14%, and 18. 5% after 1, 2, and 3 weeks of treatment, respectively.	Heart,0,5,Organ	"[{""token"": ""Heart"", ""start_span"": 0, ""end_span"": 5, ""type"": ""Organ""}]"	train
These data suggest that VEGF plays a key role in the angiogenic response that occurs with chronic bradycardia.	VEGF,24,28,Gene_or_gene_product	"[{""token"": ""VEGF"", ""start_span"": 24, ""end_span"": 28, ""type"": ""Gene_or_gene_product""}]"	train
The mechanism underlying this VEGF - associated angiogenesis may be an increase in stretch due to enhanced diastolic filling.	VEGF,30,34,Gene_or_gene_product	"[{""token"": ""VEGF"", ""start_span"": 30, ""end_span"": 34, ""type"": ""Gene_or_gene_product""}]"	train
Only a subset of patients is suitable for laser coagulation.	patients,17,25,Organism	"[{""token"": ""patients"", ""start_span"": 17, ""end_span"": 25, ""type"": ""Organism""}]"	train
Patients have been treated between January 1996 and October 1997.	Patients,0,8,Organism	"[{""token"": ""Patients"", ""start_span"": 0, ""end_span"": 8, ""type"": ""Organism""}]"	train
RESULTS: All patients completed therapy and tolerability was good.	patients,13,21,Organism	"[{""token"": ""patients"", ""start_span"": 13, ""end_span"": 21, ""type"": ""Organism""}]"	train
After 7 months median visual acuity ( VA) was 20 / 160 for the irradiated and 20 / 400 for the untreated patients.	patients,105,113,Organism	"[{""token"": ""patients"", ""start_span"": 105, ""end_span"": 113, ""type"": ""Organism""}]"	train
Patients ' reading vision could not be saved for a long - term run.	Patients,0,8,Organism	"[{""token"": ""Patients"", ""start_span"": 0, ""end_span"": 8, ""type"": ""Organism""}]"	train
Neovascularization, an essential event for the growth of solid tumors, is regulated by a number of angiogenic factors.	solid tumors,57,69,Cancer	"[{""token"": ""solid tumors"", ""start_span"": 57, ""end_span"": 69, ""type"": ""Cancer""}]"	train
The sensitivity and specificity of s - VEGF at the cut - off level of 100 pg / ml, as determined by the receiver - operating - characteristics curve, were 80. 0% and 72. 5%, respectively.	VEGF,39,43,Gene_or_gene_product	"[{""token"": ""VEGF"", ""start_span"": 39, ""end_span"": 43, ""type"": ""Gene_or_gene_product""}]"	train
PURPOSE: Clinical studies have demonstrated that intensive insulin therapy causes a transient worsening of retinopathy.	insulin,59,66,Gene_or_gene_product	"[{""token"": ""insulin"", ""start_span"": 59, ""end_span"": 66, ""type"": ""Gene_or_gene_product""}]"	train
The aim of this study was to ascertain the potential usefulness of the antiangiogenic compound linomide for treatment of von Hippel - Lindau ( VHL) - related tumors.	linomide,95,103,Chemical	"[{""token"": ""linomide"", ""start_span"": 95, ""end_span"": 103, ""type"": ""Chemical""}]"	train
In both the prevention and intervention experiments, a significant diminution of tumor size and weight was observed in the drug - treated animals.	tumor,81,86,Cancer	"[{""token"": ""tumor"", ""start_span"": 81, ""end_span"": 86, ""type"": ""Cancer""}]"	train
Oncogenic epidermal growth factor receptor mutants with tandem duplication: gene structure and effects on receptor function.	epidermal growth factor receptor,10,42,Gene_or_gene_product	"[{""token"": ""epidermal growth factor receptor"", ""start_span"": 10, ""end_span"": 42, ""type"": ""Gene_or_gene_product""}]"	train
As with duplication of the entire TK / CAIN region ( exons 18 - 26) in A - 172 cells, duplication of exons 18 - 25 is associated with a specific genomic rearrangement between flanking introns.	A - 172 cells,71,84,Cell	"[{""token"": ""A - 172 cells"", ""start_span"": 71, ""end_span"": 84, ""type"": ""Cell""}]"	train
Involved introns contain homology to recombination signal sequence ( RSS) heptamers present in the V ( D) J region of the T lymphocyte receptor gene.	T lymphocyte receptor,122,143,Gene_or_gene_product	"[{""token"": ""T lymphocyte receptor"", ""start_span"": 122, ""end_span"": 143, ""type"": ""Gene_or_gene_product""}]"	train
High - affinity binding is reduced in EGFR. TDM / 18 - 26, although the t1 / 2 of receptor internalization is not prolonged.	EGFR,38,42,Gene_or_gene_product	"[{""token"": ""EGFR"", ""start_span"": 38, ""end_span"": 42, ""type"": ""Gene_or_gene_product""}]"	train
These changes originate from increased peritoneal surface area, but the morphologic and molecular mechanisms involved remain unknown.	peritoneal surface area,39,62,Immaterial_anatomical_entity	"[{""token"": ""peritoneal surface area"", ""start_span"": 39, ""end_span"": 62, ""type"": ""Immaterial_anatomical_entity""}]"	train
They also support the implication of local advanced glycation end product deposits and liberation of VEGF in that process.	VEGF,101,105,Gene_or_gene_product	"[{""token"": ""VEGF"", ""start_span"": 101, ""end_span"": 105, ""type"": ""Gene_or_gene_product""}]"	train
Active hair growth ( anagen) is associated with angiogenesis.	hair,7,11,Multi	"[{""token"": ""hair"", ""start_span"": 7, ""end_span"": 11, ""type"": ""Multi""}]"	train
Despite these suggestive observations, no formal proof is as yet available for the concept that angiogenesis is a physiologic event that occurs all over the mature mammalian integument whenever hair follicles switch from resting ( telogen) to active growth ( anagen).	hair follicles,194,208,Multi	"[{""token"": ""hair follicles"", ""start_span"": 194, ""end_span"": 208, ""type"": ""Multi""}]"	train
Anagen - associated angiogenesis offers an attractive model for identifying the physiologic controls of cutaneous angiogenesis, and an interesting system for screening the effects of potential antiangiogenic drugs in vivo.	cutaneous,104,113,Organism_subdivision	"[{""token"": ""cutaneous"", ""start_span"": 104, ""end_span"": 113, ""type"": ""Organism_subdivision""}]"	train
The tumor may present with widespread metastases that are unresponsive to aggressive treatment.	tumor,4,9,Cancer	"[{""token"": ""tumor"", ""start_span"": 4, ""end_span"": 9, ""type"": ""Cancer""}]"	train
At other times, both the metastases and the primary tumor may spontaneously regress without treatment.	tumor,52,57,Cancer	"[{""token"": ""tumor"", ""start_span"": 52, ""end_span"": 57, ""type"": ""Cancer""}]"	train
After 4 days, these cells are harvested and cytospins made for immunostaining.	cells,20,25,Cell	"[{""token"": ""cells"", ""start_span"": 20, ""end_span"": 25, ""type"": ""Cell""}]"	train
TUNEL data are reported as percentage apoptotic cells.	cells,48,53,Cell	"[{""token"": ""cells"", ""start_span"": 48, ""end_span"": 53, ""type"": ""Cell""}]"	train
There is a significant increase in the number of apoptotic hepatocytes when they are cultured in the conditioned media.	hepatocytes,59,70,Cell	"[{""token"": ""hepatocytes"", ""start_span"": 59, ""end_span"": 70, ""type"": ""Cell""}]"	train
In contrast, the neuroblastoma cells grown in the coculture conditioned media show no increase in apoptosis.	neuroblastoma cells,17,36,Cell	"[{""token"": ""neuroblastoma cells"", ""start_span"": 17, ""end_span"": 36, ""type"": ""Cell""}]"	train
These changes should diminish apoptosis activity in the tumor cells.	tumor cells,56,67,Cell	"[{""token"": ""tumor cells"", ""start_span"": 56, ""end_span"": 67, ""type"": ""Cell""}]"	train
In contrast, the conditioned media induce elevated levels of proapoptotic mediators in the Chang hepatocytes.	hepatocytes,97,108,Cell	"[{""token"": ""hepatocytes"", ""start_span"": 97, ""end_span"": 108, ""type"": ""Cell""}]"	train
The mechanism of Notch signaling remains poorly understood.	Notch,17,22,Gene_or_gene_product	"[{""token"": ""Notch"", ""start_span"": 17, ""end_span"": 22, ""type"": ""Gene_or_gene_product""}]"	train
However, the mechanism by which Notch oncoproteins ( generically termed here as N ( ic)) induce neoplastic transformation is not known.	Notch,32,37,Gene_or_gene_product	"[{""token"": ""Notch"", ""start_span"": 32, ""end_span"": 37, ""type"": ""Gene_or_gene_product""}]"	train
PURPOSE: The poor prognosis associated with lung cancer is related to the high incidence of regional and distant metastasis.	lung cancer,44,55,Cancer	"[{""token"": ""lung cancer"", ""start_span"": 44, ""end_span"": 55, ""type"": ""Cancer""}]"	train
No significant differences between the two groups were observed in tumor size, gender, age, histology, differentiation or preoperative therapy.	tumor,67,72,Cancer	"[{""token"": ""tumor"", ""start_span"": 67, ""end_span"": 72, ""type"": ""Cancer""}]"	train
The differences in IL - 12 levels were unremarkable.	IL - 12,19,26,Gene_or_gene_product	"[{""token"": ""IL - 12"", ""start_span"": 19, ""end_span"": 26, ""type"": ""Gene_or_gene_product""}]"	train
Using univariate analysis, the S - 100beta level and metastatic profile were found to be statistically significant prognostic factors for survival.	S - 100beta,31,42,Gene_or_gene_product	"[{""token"": ""S - 100beta"", ""start_span"": 31, ""end_span"": 42, ""type"": ""Gene_or_gene_product""}]"	train
S - 100beta is also an independent prognostic marker.	S - 100beta,0,11,Gene_or_gene_product	"[{""token"": ""S - 100beta"", ""start_span"": 0, ""end_span"": 11, ""type"": ""Gene_or_gene_product""}]"	train
Pretreatment IL levels were not associated with outcome.	IL,13,15,Gene_or_gene_product	"[{""token"": ""IL"", ""start_span"": 13, ""end_span"": 15, ""type"": ""Gene_or_gene_product""}]"	train
This usually involves screening of potential anti - angiogenic compounds on endothelial cells.	endothelial cells,76,93,Cell	"[{""token"": ""endothelial cells"", ""start_span"": 76, ""end_span"": 93, ""type"": ""Cell""}]"	train
Differential sensitivity to these agents implies that more than one endothelial cell type must be used in proliferation assays to screen for novel anti - angiogenic compounds.	endothelial cell type,68,89,Cell	"[{""token"": ""endothelial cell type"", ""start_span"": 68, ""end_span"": 89, ""type"": ""Cell""}]"	train
We used neutralizing Abs to show that the IFN - inducible protein - 10 and monokine - induced by IFN - gamma chemokines are pivotal in inducing these effects.	IFN - inducible protein - 10,42,70,Gene_or_gene_product	"[{""token"": ""IFN - inducible protein - 10"", ""start_span"": 42, ""end_span"": 70, ""type"": ""Gene_or_gene_product""}]"	train
The percentage of cell apoptosis increased with the enhancing of concentration.	cell,18,22,Cell	"[{""token"": ""cell"", ""start_span"": 18, ""end_span"": 22, ""type"": ""Cell""}]"	train
In the high - level group the authors found typical DNA ladder eletrophoresis stripe.	DNA,52,55,Cellular_component	"[{""token"": ""DNA"", ""start_span"": 52, ""end_span"": 55, ""type"": ""Cellular_component""}]"	train
Effects of morphological patterning on endothelial cell migration.	endothelial cell,39,55,Cell	"[{""token"": ""endothelial cell"", ""start_span"": 39, ""end_span"": 55, ""type"": ""Cell""}]"	train
The cells on 15 - microm wide strips completely aligned in the direction of the strip, and had significantly lower shape index than those in all other groups.	cells,4,9,Cell	"[{""token"": ""cells"", ""start_span"": 4, ""end_span"": 9, ""type"": ""Cell""}]"	train
On strips of all widths, ECs tended to migrate in the direction of strips.	ECs,25,28,Cell	"[{""token"": ""ECs"", ""start_span"": 25, ""end_span"": 28, ""type"": ""Cell""}]"	train
ECs on 15 - microm wide strips had highest speed, particularly in the direction of the strip.	ECs,0,3,Cell	"[{""token"": ""ECs"", ""start_span"": 0, ""end_span"": 3, ""type"": ""Cell""}]"	train
Current prospects for controlling cancer growth with non - cytotoxic agents - - nutrients, phytochemicals, herbal extracts, and available drugs.	cancer,34,40,Cancer	"[{""token"": ""cancer"", ""start_span"": 34, ""end_span"": 40, ""type"": ""Cancer""}]"	train
Many of these measures appear suitable for use in cancer prevention.	cancer,50,56,Cancer	"[{""token"": ""cancer"", ""start_span"": 50, ""end_span"": 56, ""type"": ""Cancer""}]"	train
Oncogenic mechanisms of Evi - 1 protein.	Evi - 1,24,31,Gene_or_gene_product	"[{""token"": ""Evi - 1"", ""start_span"": 24, ""end_span"": 31, ""type"": ""Gene_or_gene_product""}]"	train
Two separate regions of Evi - 1 are responsible for this repression, one of which is the first zinc - finger domain.	Evi - 1,24,31,Gene_or_gene_product	"[{""token"": ""Evi - 1"", ""start_span"": 24, ""end_span"": 31, ""type"": ""Gene_or_gene_product""}]"	train
The studies reported here were designed to help elucidate PAI - 1 ' s contribution to the invasive and migratory phenotype.	PAI - 1,58,65,Gene_or_gene_product	"[{""token"": ""PAI - 1"", ""start_span"": 58, ""end_span"": 65, ""type"": ""Gene_or_gene_product""}]"	train
These data highlight the importance of a balanced proteolysis and suggest an additional role for PAI - 1 distinct from its role in proteolysis.	PAI - 1,97,104,Gene_or_gene_product	"[{""token"": ""PAI - 1"", ""start_span"": 97, ""end_span"": 104, ""type"": ""Gene_or_gene_product""}]"	train
HSP27 is implicated in protein - protein interactions such as folding, translocation, and prevention of inappropriate protein aggregation.	HSP27,0,5,Gene_or_gene_product	"[{""token"": ""HSP27"", ""start_span"": 0, ""end_span"": 5, ""type"": ""Gene_or_gene_product""}]"	train
Many of their functions suggest that they play important roles in cancers.	cancers,66,73,Cancer	"[{""token"": ""cancers"", ""start_span"": 66, ""end_span"": 73, ""type"": ""Cancer""}]"	train
HSP27 expression was positive staining ( +) in 20 ( 50%), weak or negative staining ( -) in 20 ( 50%) of total 40 cases.	HSP27,0,5,Gene_or_gene_product	"[{""token"": ""HSP27"", ""start_span"": 0, ""end_span"": 5, ""type"": ""Gene_or_gene_product""}]"	train
However, when compared with clinicopathological features, the expression of HSP27 correlated inversely with survival period.	HSP27,76,81,Gene_or_gene_product	"[{""token"": ""HSP27"", ""start_span"": 76, ""end_span"": 81, ""type"": ""Gene_or_gene_product""}]"	train
BACKGROUND: Angiogenesis is essential for tumor growth and relies on the production of angiogenic factors.	tumor,42,47,Cancer	"[{""token"": ""tumor"", ""start_span"": 42, ""end_span"": 47, ""type"": ""Cancer""}]"	train
Hypoxia - inducible factor 1 activation by aerobic glycolysis implicates the Warburg effect in carcinogenesis.	Hypoxia - inducible factor 1,0,28,Gene_or_gene_product	"[{""token"": ""Hypoxia - inducible factor 1"", ""start_span"": 0, ""end_span"": 28, ""type"": ""Gene_or_gene_product""}]"	train
Cancer cells display high rates of aerobic glycolysis, a phenomenon known historically as the Warburg effect.	Cancer cells,0,12,Cell	"[{""token"": ""Cancer cells"", ""start_span"": 0, ""end_span"": 12, ""type"": ""Cell""}]"	train
Hypoxia - induced gene expression in cancer cells has been linked to malignant transformation.	cancer cells,37,49,Cell	"[{""token"": ""cancer cells"", ""start_span"": 37, ""end_span"": 49, ""type"": ""Cell""}]"	train
Risk of myelodysplastic syndrome and acute myeloid leukemia in congenital neutropenias.	acute myeloid leukemia,37,59,Cancer	"[{""token"": ""acute myeloid leukemia"", ""start_span"": 37, ""end_span"": 59, ""type"": ""Cancer""}]"	train
The issue is complicated because both disorders have a propensity for MDS or AML as part of their natural history.	AML,77,80,Cancer	"[{""token"": ""AML"", ""start_span"": 77, ""end_span"": 80, ""type"": ""Cancer""}]"	train
"In those with "" soft "" signs of MDS, such as an isolated clonal cytogenetic change but without other evidence of MDS, or with an isolated G - CSF receptor mutation, there is room for conservative management."	G - CSF receptor,138,154,Gene_or_gene_product	"[{""token"": ""G - CSF receptor"", ""start_span"": 138, ""end_span"": 154, ""type"": ""Gene_or_gene_product""}]"	train
The introduction of mutations into the T - antigen J domain resulted in mutation - specific and variable inhibition of apoptosis.	T - antigen,39,50,Gene_or_gene_product	"[{""token"": ""T - antigen"", ""start_span"": 39, ""end_span"": 50, ""type"": ""Gene_or_gene_product""}]"	train
This result suggested that either the structural or the functional integrity of the J domain is required to sensitize cells to apoptosis.	cells,118,123,Cell	"[{""token"": ""cells"", ""start_span"": 118, ""end_span"": 123, ""type"": ""Cell""}]"	train
The combination diagnosis / treatment device should be useful in optimizing FV treatment and in refining and evaluating the efficacy of DEP in future clinical trials.	FV,76,78,Multi	"[{""token"": ""FV"", ""start_span"": 76, ""end_span"": 78, ""type"": ""Multi""}]"	train
This suggested that CLA might inhibit angiogenesis in vivo.	CLA,20,23,Chemical	"[{""token"": ""CLA"", ""start_span"": 20, ""end_span"": 23, ""type"": ""Chemical""}]"	train
The ability of CLA to inhibit angiogenesis may contribute to its efficacy as a chemopreventive agent.	CLA,15,18,Chemical	"[{""token"": ""CLA"", ""start_span"": 15, ""end_span"": 18, ""type"": ""Chemical""}]"	train
Little is known about the specificity of angiogenic properties of oral cancer cells and the possible mechanisms.	oral cancer cells,66,83,Cell	"[{""token"": ""oral cancer cells"", ""start_span"": 66, ""end_span"": 83, ""type"": ""Cell""}]"	train
PURPOSE: Members of the transforming growth factor ( TGF) - beta superfamily play critical roles in regulation of various cellular functions.	cellular,122,130,Cell	"[{""token"": ""cellular"", ""start_span"": 122, ""end_span"": 130, ""type"": ""Cell""}]"	train
Arteriogenesis: the development and growth of collateral arteries.	collateral arteries,46,65,Multi	"[{""token"": ""collateral arteries"", ""start_span"": 46, ""end_span"": 65, ""type"": ""Multi""}]"	train
This may explain why some patients remain without symptoms or signs of ischemia.	patients,26,34,Organism	"[{""token"": ""patients"", ""start_span"": 26, ""end_span"": 34, ""type"": ""Organism""}]"	train
This reduction disappeared with increasing distance from the tumor.	tumor,61,66,Cancer	"[{""token"": ""tumor"", ""start_span"": 61, ""end_span"": 66, ""type"": ""Cancer""}]"	train
Angiogenesis is a critical process in solid tumor growth and metastasis.	solid tumor,38,49,Cancer	"[{""token"": ""solid tumor"", ""start_span"": 38, ""end_span"": 49, ""type"": ""Cancer""}]"	train
Retinopathy is the most common microvascular diabetes complication and represents a major threat to the eyesight.	microvascular,31,44,Tissue	"[{""token"": ""microvascular"", ""start_span"": 31, ""end_span"": 44, ""type"": ""Tissue""}]"	train
PEDF was found to be decreased in diabetics ( mean values: 2080 vs. 5780 ng / ml; p = 0. 04) compared to controls.	PEDF,0,4,Gene_or_gene_product	"[{""token"": ""PEDF"", ""start_span"": 0, ""end_span"": 4, ""type"": ""Gene_or_gene_product""}]"	train
Likewise, in diabetics without proliferation, angiogenic activity was also blocked by antibodies to PEDF.	PEDF,100,104,Gene_or_gene_product	"[{""token"": ""PEDF"", ""start_span"": 100, ""end_span"": 104, ""type"": ""Gene_or_gene_product""}]"	train
We will demonstrate here that the level of the natural ocular anti - angiogenic agent PEDF is inversely associated with proliferative retinopathy.	PEDF,86,90,Gene_or_gene_product	"[{""token"": ""PEDF"", ""start_span"": 86, ""end_span"": 90, ""type"": ""Gene_or_gene_product""}]"	train
The rapid cleavage of Tie1 is followed by a transcriptional down - regulation in response to shear stress.	Tie1,22,26,Gene_or_gene_product	"[{""token"": ""Tie1"", ""start_span"": 22, ""end_span"": 26, ""type"": ""Gene_or_gene_product""}]"	train
Shear stress - induced transcriptional suppression of Tie1 is mediated by a negative shear stress response element, localized in a region of 250 bp within the promoter.	Tie1,54,58,Gene_or_gene_product	"[{""token"": ""Tie1"", ""start_span"": 54, ""end_span"": 58, ""type"": ""Gene_or_gene_product""}]"	train
Cells cannot survive extended severe ischemia but may be able to adapt to a moderate condition where diffusion to and from bordering nonischemic regions sustains vital functions.	Cells,0,5,Cell	"[{""token"": ""Cells"", ""start_span"": 0, ""end_span"": 5, ""type"": ""Cell""}]"	train
Under this condition, the secondary functions of effected cells are likely to be impaired, and a new metabolic equilibrium is established, determined by the level of cross - diffusion and degree of hypoxia.	cells,58,63,Cell	"[{""token"": ""cells"", ""start_span"": 58, ""end_span"": 63, ""type"": ""Cell""}]"	train
Ischemic cardiac muscle is additionally vulnerable because reperfusion is essential for survival but reperfusion itself poses additional stress principally from increased production of free radicals during reoxygenation.	cardiac muscle,9,23,Tissue	"[{""token"": ""cardiac muscle"", ""start_span"": 9, ""end_span"": 23, ""type"": ""Tissue""}]"	train
The treatment possibilities for ischemia - related vascular disease are limited.	vascular,51,59,Multi	"[{""token"": ""vascular"", ""start_span"": 51, ""end_span"": 59, ""type"": ""Multi""}]"	train
An alternative and rather obvious strategy to treat ischemia is to activate endogenous angiogenic or arteriogenic pathways to stimulate revascularization of the tissue.	tissue,161,167,Tissue	"[{""token"": ""tissue"", ""start_span"": 161, ""end_span"": 167, ""type"": ""Tissue""}]"	train
This review focuses on the application of therapeutic angiogenesis for treating ischemic muscle disease and includes a critical evaluation of the parameters and limitations of current procedures.	muscle,89,95,Organ	"[{""token"": ""muscle"", ""start_span"": 89, ""end_span"": 95, ""type"": ""Organ""}]"	train
This growth factor system exerts multiple physiologic effects on the vasculature through both endocrine and autocrine / paracrine mechanisms.	vasculature,69,80,Anatomical_system	"[{""token"": ""vasculature"", ""start_span"": 69, ""end_span"": 80, ""type"": ""Anatomical_system""}]"	train
PURPOSE: Neovascularization has profound effects on tumor growth and metastasis.	tumor,52,57,Cancer	"[{""token"": ""tumor"", ""start_span"": 52, ""end_span"": 57, ""type"": ""Cancer""}]"	train
RESULTS: The OSCC samples had an average h - MVD score of 27. 7 / mm ( 2).	OSCC samples,13,25,Cancer	"[{""token"": ""OSCC samples"", ""start_span"": 13, ""end_span"": 25, ""type"": ""Cancer""}]"	train
A marginally significant association was also noted between the h - MVD and patient survival ( P =. 056).	patient,76,83,Organism	"[{""token"": ""patient"", ""start_span"": 76, ""end_span"": 83, ""type"": ""Organism""}]"	train
Promotion of tumorigenesis by heterozygous disruption of the beclin 1 autophagy gene.	beclin 1,61,69,Gene_or_gene_product	"[{""token"": ""beclin 1"", ""start_span"": 61, ""end_span"": 69, ""type"": ""Gene_or_gene_product""}]"	train
However, as yet, there is no genetic evidence for a role of autophagy genes in tumor suppression.	tumor,79,84,Cancer	"[{""token"": ""tumor"", ""start_span"": 79, ""end_span"": 84, ""type"": ""Cancer""}]"	train
Morphogenesis of embryonic CNS vessels.	embryonic CNS vessels,17,38,Multi	"[{""token"": ""embryonic CNS vessels"", ""start_span"": 17, ""end_span"": 38, ""type"": ""Multi""}]"	train
TGFbeta1, back to the future: revisiting its role as a transforming growth factor.	TGFbeta1,0,8,Gene_or_gene_product	"[{""token"": ""TGFbeta1"", ""start_span"": 0, ""end_span"": 8, ""type"": ""Gene_or_gene_product""}]"	train
Similar results have been obtained with tumor cell lines and experimental animal models.	tumor cell lines,40,56,Cell	"[{""token"": ""tumor cell lines"", ""start_span"": 40, ""end_span"": 56, ""type"": ""Cell""}]"	train
This event is independent of fibrin formation.	fibrin,29,35,Gene_or_gene_product	"[{""token"": ""fibrin"", ""start_span"": 29, ""end_span"": 35, ""type"": ""Gene_or_gene_product""}]"	train
Thrombin increases the mRNA and protein levels of alpha ( v) beta ( 3) integrin and serves as a ligand to this receptor.	Thrombin,0,8,Gene_or_gene_product	"[{""token"": ""Thrombin"", ""start_span"": 0, ""end_span"": 8, ""type"": ""Gene_or_gene_product""}]"	train
Matrix metalloproteinase activity, determined using a quenched fluorescence substrate assay, increased during early healing ( 3 - 8 weeks) compared to controls, and then decreased between 24 and 36 weeks after surgery ( p less than 0. 05 until 24 weeks, Mann - Whitney U - test).	Matrix metalloproteinase,0,24,Gene_or_gene_product	"[{""token"": ""Matrix metalloproteinase"", ""start_span"": 0, ""end_span"": 24, ""type"": ""Gene_or_gene_product""}]"	train
Tissue inhibitor of metalloproteinase - 1 staining was relatively sparse but was significantly increased until 8 weeks after surgery.	Tissue inhibitor of metalloproteinase - 1,0,41,Gene_or_gene_product	"[{""token"": ""Tissue inhibitor of metalloproteinase - 1"", ""start_span"": 0, ""end_span"": 41, ""type"": ""Gene_or_gene_product""}]"	train
p53 is a protein with many talents.	p53,0,3,Gene_or_gene_product	"[{""token"": ""p53"", ""start_span"": 0, ""end_span"": 3, ""type"": ""Gene_or_gene_product""}]"	train
p53 does so through the induction of genes leading to growth arrest or apoptosis.	p53,0,3,Gene_or_gene_product	"[{""token"": ""p53"", ""start_span"": 0, ""end_span"": 3, ""type"": ""Gene_or_gene_product""}]"	train
Here we review and comment on these findings and on their implications for cancer biology.	cancer,75,81,Cancer	"[{""token"": ""cancer"", ""start_span"": 75, ""end_span"": 81, ""type"": ""Cancer""}]"	train
IGF - 1 mRNA ( n = 10 / group) and protein levels ( n = 6 / group) were higher ( P less than 0. 05 for all groups) at 3, 7, and 14 days compared with controls.	IGF - 1,0,7,Gene_or_gene_product	"[{""token"": ""IGF - 1"", ""start_span"": 0, ""end_span"": 7, ""type"": ""Gene_or_gene_product""}]"	train
RESULTS: LOH of D10S541, D10S583 and D10S1687 was found in 37. 5% ( 21 / 56) of advanced gastric cancers.	gastric cancers,89,104,Cancer	"[{""token"": ""gastric cancers"", ""start_span"": 89, ""end_span"": 104, ""type"": ""Cancer""}]"	train
PTEN protein expression paralleled with its mRNA expression ( P < 0. 05).	PTEN,0,4,Gene_or_gene_product	"[{""token"": ""PTEN"", ""start_span"": 0, ""end_span"": 4, ""type"": ""Gene_or_gene_product""}]"	train
OBJECTIVE: Dependence on glycolysis is a hallmark of malignant tumors.	malignant tumors,53,69,Cancer	"[{""token"": ""malignant tumors"", ""start_span"": 53, ""end_span"": 69, ""type"": ""Cancer""}]"	train
Prolonged silencing of both MCTs reduced viability by 75% individually and 92% in combination, as measured by both phenotypic and flow cytometric analyses.	MCTs,28,32,Gene_or_gene_product	"[{""token"": ""MCTs"", ""start_span"": 28, ""end_span"": 32, ""type"": ""Gene_or_gene_product""}]"	train
Hypoxia - responsive element - mediated soluble Tie2 vector exhibits an anti - angiogenic activity in vitro under hypoxic condition.	Tie2,48,52,Gene_or_gene_product	"[{""token"": ""Tie2"", ""start_span"": 48, ""end_span"": 52, ""type"": ""Gene_or_gene_product""}]"	train
The molecular mechanisms regulating the gene expression under hypoxic conditions could increase the therapeutic window of tumor - specific delivery systems.	tumor,122,127,Cancer	"[{""token"": ""tumor"", ""start_span"": 122, ""end_span"": 127, ""type"": ""Cancer""}]"	train
Matrix metalloproteinase / tissue inhibitors of matrix metalloproteinase phenotype identifies poor prognosis colorectal cancers.	colorectal cancers,109,127,Cancer	"[{""token"": ""colorectal cancers"", ""start_span"": 109, ""end_span"": 127, ""type"": ""Cancer""}]"	train
Therefore, to understand their role in tumor invasion, it is necessary to evaluate them collectively.	tumor,39,44,Cancer	"[{""token"": ""tumor"", ""start_span"": 39, ""end_span"": 44, ""type"": ""Cancer""}]"	train
An immunohistochemical score based on the intensity of immunoreactivity and proportion of immunoreactive cells was established for each MMP and TIMP.	cells,105,110,Cell	"[{""token"": ""cells"", ""start_span"": 105, ""end_span"": 110, ""type"": ""Cell""}]"	train
RESULTS: The MMP / TIMP profile defined by hierarchical cluster analysis of the immunohistochemical score identifies a distinct group of colorectal cancers with poor prognosis ( log - rank test, 12. 22, P = 0. 0005).	colorectal cancers,137,155,Cancer	"[{""token"": ""colorectal cancers"", ""start_span"": 137, ""end_span"": 155, ""type"": ""Cancer""}]"	train
"The median survival time of patients in this survival group was 18 months compared with a median survival of 49 months in the "" good "" survival group."	patients,28,36,Organism	"[{""token"": ""patients"", ""start_span"": 28, ""end_span"": 36, ""type"": ""Organism""}]"	train
CONCLUSIONS: This study has identified that the MMP / TIMP profile is an independent indicator of poor prognosis in colorectal cancer.	colorectal cancer,116,133,Cancer	"[{""token"": ""colorectal cancer"", ""start_span"": 116, ""end_span"": 133, ""type"": ""Cancer""}]"	train
Solid tumors are frequently necrotic and hypoxic due to poor vascularization.	Solid tumors,0,12,Cancer	"[{""token"": ""Solid tumors"", ""start_span"": 0, ""end_span"": 12, ""type"": ""Cancer""}]"	train
Tumor cells adapt to hypoxia by modulating their phenotype.	Tumor cells,0,11,Cell	"[{""token"": ""Tumor cells"", ""start_span"": 0, ""end_span"": 11, ""type"": ""Cell""}]"	train
Low glucose potentiated the effect of hypoxia.	glucose,4,11,Chemical	"[{""token"": ""glucose"", ""start_span"": 4, ""end_span"": 11, ""type"": ""Chemical""}]"	train
We used these data to establish a convenient, effective and non - radioactive ELISA screening technique for the identification and evaluation of potential inhibitors for VEGFR - 2 kinase.	VEGFR - 2,170,179,Gene_or_gene_product	"[{""token"": ""VEGFR - 2"", ""start_span"": 170, ""end_span"": 179, ""type"": ""Gene_or_gene_product""}]"	train
Role of thrombogenic factors in the development of atherosclerosis.	thrombogenic factors,8,28,Gene_or_gene_product	"[{""token"": ""thrombogenic factors"", ""start_span"": 8, ""end_span"": 28, ""type"": ""Gene_or_gene_product""}]"	train
However, whether hemostatic factors contribute directly or indirectly to the pathogenesis of atherosclerosis remains uncertain.	hemostatic factors,17,35,Gene_or_gene_product	"[{""token"": ""hemostatic factors"", ""start_span"": 17, ""end_span"": 35, ""type"": ""Gene_or_gene_product""}]"	train
Several factors contribute to the start of intimal thickening.	intimal,43,50,Tissue	"[{""token"": ""intimal"", ""start_span"": 43, ""end_span"": 50, ""type"": ""Tissue""}]"	train
Angiogenin, a 14. 2 kD polypeptide that was originally noted for its angiogenic activity, is now increasingly recognized to have a multiplicity of biological roles in both physiological and pathological conditions.	Angiogenin,0,10,Gene_or_gene_product	"[{""token"": ""Angiogenin"", ""start_span"": 0, ""end_span"": 10, ""type"": ""Gene_or_gene_product""}]"	train
Interestingly, both INK4 genes express alternative splicing variants.	INK4,20,24,Gene_or_gene_product	"[{""token"": ""INK4"", ""start_span"": 20, ""end_span"": 24, ""type"": ""Gene_or_gene_product""}]"	train
Rofecoxib as adjunctive therapy for haemophilic arthropathy.	Rofecoxib,0,9,Chemical	"[{""token"": ""Rofecoxib"", ""start_span"": 0, ""end_span"": 9, ""type"": ""Chemical""}]"	train
Joint haemorrhage and subsequent haemophilic arthropathy are significant complications in haemophilia.	Joint,0,5,Multi	"[{""token"": ""Joint"", ""start_span"": 0, ""end_span"": 5, ""type"": ""Multi""}]"	train
This is the largest study to date evaluating COX - 2 inhibitors as adjunctive therapy in haemophilia and suggests that these agents may be an important adjunctive therapy in the management of haemophilia.	COX - 2,45,52,Gene_or_gene_product	"[{""token"": ""COX - 2"", ""start_span"": 45, ""end_span"": 52, ""type"": ""Gene_or_gene_product""}]"	train
Both agents inhibited angiogenesis and induced apoptosis when compared to tumors from control animals.	tumors,74,80,Cancer	"[{""token"": ""tumors"", ""start_span"": 74, ""end_span"": 80, ""type"": ""Cancer""}]"	train
Six weeks later, mice were randomly divided into four treatment groups: untreated controls; 10 minute daily TEMF; 200 cGy of IR every other day ( total 800 cGy); IR plus daily TEMF.	mice,17,21,Organism	"[{""token"": ""mice"", ""start_span"": 17, ""end_span"": 21, ""type"": ""Organism""}]"	train
Some mice in each group were euthanized 24 hours after the end of IR.	mice,5,9,Organism	"[{""token"": ""mice"", ""start_span"": 5, ""end_span"": 9, ""type"": ""Organism""}]"	train
CONCLUSION: TEMF therapy provided a safe means for retarding tumor vascularization, growth and metastasis.	tumor,61,66,Cancer	"[{""token"": ""tumor"", ""start_span"": 61, ""end_span"": 66, ""type"": ""Cancer""}]"	train
These results also suggest therapeutic implications concerning Wnt signaling inhibitors.	Wnt,63,66,Gene_or_gene_product	"[{""token"": ""Wnt"", ""start_span"": 63, ""end_span"": 66, ""type"": ""Gene_or_gene_product""}]"	train
Neovascularization is an early and critical step in tumor development and progression.	tumor,52,57,Cancer	"[{""token"": ""tumor"", ""start_span"": 52, ""end_span"": 57, ""type"": ""Cancer""}]"	train
Tumor vessels are distinct from their normal counterparts morphologically as well as at a molecular level.	Tumor vessels,0,13,Multi	"[{""token"": ""Tumor vessels"", ""start_span"": 0, ""end_span"": 13, ""type"": ""Multi""}]"	train
An understanding of the relative contribution of various pathways in the development of tumor vasculature is critical for developing effective and selective therapeutic approaches.	tumor vasculature,88,105,Multi	"[{""token"": ""tumor vasculature"", ""start_span"": 88, ""end_span"": 105, ""type"": ""Multi""}]"	train
In this review, the mechanisms and factors involved in tumor blood vessel formation are discussed.	tumor blood vessel,55,73,Multi	"[{""token"": ""tumor blood vessel"", ""start_span"": 55, ""end_span"": 73, ""type"": ""Multi""}]"	train
Normal and transforming functions of RUNX1: a perspective.	RUNX1,37,42,Gene_or_gene_product	"[{""token"": ""RUNX1"", ""start_span"": 37, ""end_span"": 42, ""type"": ""Gene_or_gene_product""}]"	train
Thalidomide [ alpha - ( N - phthalimido) - glutarimide] is known to be a potent inhibitor of angiogenesis, but the mechanism of its inhibitory action remains unclear.	Thalidomide,0,11,Chemical	"[{""token"": ""Thalidomide"", ""start_span"": 0, ""end_span"": 11, ""type"": ""Chemical""}]"	train
The aim of the study was to investigate the potential influence of thalidomide on the several steps of angiogenesis, using in vitro models.	thalidomide,67,78,Chemical	"[{""token"": ""thalidomide"", ""start_span"": 67, ""end_span"": 78, ""type"": ""Chemical""}]"	train
The specific isoform ( s) of PKC responsible for each of these changes has not been previously identified.	PKC,29,32,Gene_or_gene_product	"[{""token"": ""PKC"", ""start_span"": 29, ""end_span"": 32, ""type"": ""Gene_or_gene_product""}]"	train
Immunohistochemistry with 27 primary antibodies was performed in 100 formalin - fixed paraffin - embedded samples of invasive ductal carcinomas.	invasive ductal carcinomas,117,143,Cancer	"[{""token"": ""invasive ductal carcinomas"", ""start_span"": 117, ""end_span"": 143, ""type"": ""Cancer""}]"	train
Angiogenesis plays a critical role in the growth and metastasis of tumors.	tumors,67,73,Cancer	"[{""token"": ""tumors"", ""start_span"": 67, ""end_span"": 73, ""type"": ""Cancer""}]"	train
Thus, supplementation with L - Carnitine as an adjuvant therapy may be promising in alleviating the systemic side - effects of chemotherapeutics.	L - Carnitine,27,40,Chemical	"[{""token"": ""L - Carnitine"", ""start_span"": 27, ""end_span"": 40, ""type"": ""Chemical""}]"	train
However, the exact mechanism underlying the cytotoxic effects of pacitaxel, especially in the survival - signalling pathway, is poorly understood.	pacitaxel,65,74,Chemical	"[{""token"": ""pacitaxel"", ""start_span"": 65, ""end_span"": 74, ""type"": ""Chemical""}]"	train
The cell cycle progression and sub - G1 population were analysed by flow cytometry.	cell,4,8,Cell	"[{""token"": ""cell"", ""start_span"": 4, ""end_span"": 8, ""type"": ""Cell""}]"	train
Apoptosis was further measured by DNA fragmentation and microscope examination.	DNA,34,37,Cellular_component	"[{""token"": ""DNA"", ""start_span"": 34, ""end_span"": 37, ""type"": ""Cellular_component""}]"	train
This effect was mediated, at least partly, through caspase activation.	caspase,51,58,Gene_or_gene_product	"[{""token"": ""caspase"", ""start_span"": 51, ""end_span"": 58, ""type"": ""Gene_or_gene_product""}]"	train
Cancer is a disease largely dependent on neoangiogenesis.	Cancer,0,6,Cancer	"[{""token"": ""Cancer"", ""start_span"": 0, ""end_span"": 6, ""type"": ""Cancer""}]"	train
Unusual in healthy individuals, their presence in elevated numbers often indicates substantial vascular endothelial perturbation.	vascular endothelial,95,115,Tissue	"[{""token"": ""vascular endothelial"", ""start_span"": 95, ""end_span"": 115, ""type"": ""Tissue""}]"	train
The association of fibrinogen levels with clinical / pathological findings and clinical outcome was evaluated.	fibrinogen,19,29,Gene_or_gene_product	"[{""token"": ""fibrinogen"", ""start_span"": 19, ""end_span"": 29, ""type"": ""Gene_or_gene_product""}]"	train
METHODS: We analyzed the hypermethylation status and expression of the gene and 12q13. 1 loss of heterozygosity in 31 PCNSLs.	PCNSLs,118,124,Cancer	"[{""token"": ""PCNSLs"", ""start_span"": 118, ""end_span"": 124, ""type"": ""Cancer""}]"	train
In addition, higher apoptotic counts were associated with HRK positivity.	HRK,58,61,Gene_or_gene_product	"[{""token"": ""HRK"", ""start_span"": 58, ""end_span"": 61, ""type"": ""Gene_or_gene_product""}]"	train
Hypermethylation of the HRK promoter alone was not associated with overall outcome, but relapse - free survival was significantly shorter.	HRK,24,27,Gene_or_gene_product	"[{""token"": ""HRK"", ""start_span"": 24, ""end_span"": 27, ""type"": ""Gene_or_gene_product""}]"	train
Considering the relatively few number of patients treated by angiogenic therapy, the interpretation of clinical results needs cautiousness.	patients,41,49,Organism	"[{""token"": ""patients"", ""start_span"": 41, ""end_span"": 49, ""type"": ""Organism""}]"	train
Two distraction rates ( 0. 5 and 1 mm / day) were compared and for each group three patients were analyzed.	patients,84,92,Organism	"[{""token"": ""patients"", ""start_span"": 84, ""end_span"": 92, ""type"": ""Organism""}]"	train
Because poor skin wound healing associated with diabetes is thought to be partly a result from impaired angiogenesis, treatments that improve angiogenesis could have important clinical applications.	skin wound,13,23,Pathological_formation	"[{""token"": ""skin wound"", ""start_span"": 13, ""end_span"": 23, ""type"": ""Pathological_formation""}]"	train
Our data indicates that this therapeutic approach markedly promotes angiogenesis and granulation tissue formation in comparison with other conditions 14 days after wounding.	granulation tissue,85,103,Tissue	"[{""token"": ""granulation tissue"", ""start_span"": 85, ""end_span"": 103, ""type"": ""Tissue""}]"	train
Because of this, and the virtual explosion of interest in pomegranate as a medicinal and nutritional product that has followed, this review is accordingly launched.	pomegranate,58,69,Organism	"[{""token"": ""pomegranate"", ""start_span"": 58, ""end_span"": 69, ""type"": ""Organism""}]"	train
This was accompanied by increased phosphorylation of the VEGF receptor 2.	VEGF receptor 2,57,72,Gene_or_gene_product	"[{""token"": ""VEGF receptor 2"", ""start_span"": 57, ""end_span"": 72, ""type"": ""Gene_or_gene_product""}]"	train
Furthermore, these results demonstrate that different changes of proinflammatory cytokines, CRP and inhibiting factors are consistent with associated clinical benefit or with disease progression, respectively.	CRP,92,95,Gene_or_gene_product	"[{""token"": ""CRP"", ""start_span"": 92, ""end_span"": 95, ""type"": ""Gene_or_gene_product""}]"	train
These results demonstrate the importance of specific oncogene interaction in myeloid leukemogenesis.	myeloid,77,84,Cell	"[{""token"": ""myeloid"", ""start_span"": 77, ""end_span"": 84, ""type"": ""Cell""}]"	train
They are also known to trigger free radical generation.	free radical,31,43,Chemical	"[{""token"": ""free radical"", ""start_span"": 31, ""end_span"": 43, ""type"": ""Chemical""}]"	train
No AP - 1 expression was found 19 weeks after initiation.	AP - 1,3,9,Gene_or_gene_product	"[{""token"": ""AP - 1"", ""start_span"": 3, ""end_span"": 9, ""type"": ""Gene_or_gene_product""}]"	train
These results indicate that Hyp is a powerful anti - inflammatory compound with therapeutic potential, and they elucidate mechanistic keys.	Hyp,28,31,Chemical	"[{""token"": ""Hyp"", ""start_span"": 28, ""end_span"": 31, ""type"": ""Chemical""}]"	train
Intimal proliferation was present in 10 of 11 irreversible PHT cases, but never observed in reversible PHT ( p less than 0. 001).	Intimal,0,7,Tissue	"[{""token"": ""Intimal"", ""start_span"": 0, ""end_span"": 7, ""type"": ""Tissue""}]"	train
Similarly, perivascular inflammatory T - cells expressed more antiapoptotic proteins in irreversible PHT ( p less than 0. 01).	perivascular inflammatory T - cells,11,46,Cell	"[{""token"": ""perivascular inflammatory T - cells"", ""start_span"": 11, ""end_span"": 46, ""type"": ""Cell""}]"	train
To date, the potential oncogenic properties of Tsg101 have not been examined in vivo owing to the lack of appropriate model systems.	Tsg101,47,53,Gene_or_gene_product	"[{""token"": ""Tsg101"", ""start_span"": 47, ""end_span"": 53, ""type"": ""Gene_or_gene_product""}]"	train
Very low - dose irradiation ( 2 x 2 Gy) is a new, effective, and safe local treatment for follicular lymphoma.	follicular lymphoma,90,109,Cancer	"[{""token"": ""follicular lymphoma"", ""start_span"": 90, ""end_span"": 109, ""type"": ""Cancer""}]"	train
These biologic insights are important arguments to advocate the use of low - dose radiotherapy as an effective palliative treatment for follicular lymphoma.	follicular lymphoma,136,155,Cancer	"[{""token"": ""follicular lymphoma"", ""start_span"": 136, ""end_span"": 155, ""type"": ""Cancer""}]"	train
Frequent coffee consumption has been associated with a reduced risk of colorectal cancer in a number of case - control studies.	colorectal cancer,71,88,Cancer	"[{""token"": ""colorectal cancer"", ""start_span"": 71, ""end_span"": 88, ""type"": ""Cancer""}]"	train
Modulating metastasis by a lymphangiogenic switch in prostate cancer.	prostate cancer,53,68,Cancer	"[{""token"": ""prostate cancer"", ""start_span"": 53, ""end_span"": 68, ""type"": ""Cancer""}]"	train
Our aim was to investigate the role of tumor lymphangiogenesis during metastasis.	tumor,39,44,Cancer	"[{""token"": ""tumor"", ""start_span"": 39, ""end_span"": 44, ""type"": ""Cancer""}]"	train
Metastatic lesions were confirmed by immunohistochemistry.	Metastatic lesions,0,18,Cancer	"[{""token"": ""Metastatic lesions"", ""start_span"": 0, ""end_span"": 18, ""type"": ""Cancer""}]"	train
Additionally, the angiogenic and lymphangiogenic profiles of the tumors were characterized.	tumors,65,71,Cancer	"[{""token"": ""tumors"", ""start_span"": 65, ""end_span"": 71, ""type"": ""Cancer""}]"	train
After 15 days, the clots were examined by histology and electron microscopy.	clots,19,24,Organism_substance	"[{""token"": ""clots"", ""start_span"": 19, ""end_span"": 24, ""type"": ""Organism_substance""}]"	train
Presence of blood vessels was confirmed with histology and electron microscopy.	blood vessels,12,25,Multi	"[{""token"": ""blood vessels"", ""start_span"": 12, ""end_span"": 25, ""type"": ""Multi""}]"	train
This assay allows exploration of angiogenesis in fat tissue.	fat tissue,49,59,Tissue	"[{""token"": ""fat tissue"", ""start_span"": 49, ""end_span"": 59, ""type"": ""Tissue""}]"	train
These data provide further evidence of the existing relationship between pro - inflammatory molecules and ovarian cancer progression.	ovarian cancer,106,120,Cancer	"[{""token"": ""ovarian cancer"", ""start_span"": 106, ""end_span"": 120, ""type"": ""Cancer""}]"	train
[ Photodynamic therapy in severe chronic central serous chorioretinopaty]	serous,49,55,Organism_substance	"[{""token"": ""serous"", ""start_span"": 49, ""end_span"": 55, ""type"": ""Organism_substance""}]"	train
OBJECTIVE: To determine the efficacy of Photodynamic Therapy ( PDT) in chronic Central Serous Chorioretinopathy ( CSC).	Serous,87,93,Organism_substance	"[{""token"": ""Serous"", ""start_span"": 87, ""end_span"": 93, ""type"": ""Organism_substance""}]"	train
METHODS: Patients diagnosed with chronic CSC, with clinical evidence of activity and treated with Photodynamic Therapy, are included in this report.	Patients,9,17,Organism	"[{""token"": ""Patients"", ""start_span"": 9, ""end_span"": 17, ""type"": ""Organism""}]"	train
35% of eyes improved their BCVA by 2 lines or more, 45% remained stable and 18% lost 2 lines or more.	eyes,7,11,Organ	"[{""token"": ""eyes"", ""start_span"": 7, ""end_span"": 11, ""type"": ""Organ""}]"	train
Choroidal hyperpermeability was reduced in every case.	Choroidal,0,9,Multi	"[{""token"": ""Choroidal"", ""start_span"": 0, ""end_span"": 9, ""type"": ""Multi""}]"	train
Neurosensorial retinal detachment decreased in 80% of cases.	retinal,15,22,Multi	"[{""token"": ""retinal"", ""start_span"": 15, ""end_span"": 22, ""type"": ""Multi""}]"	train
However, the increase in visual acuity is variable, probably due to the extent of RPE damage.	RPE,82,85,Tissue	"[{""token"": ""RPE"", ""start_span"": 82, ""end_span"": 85, ""type"": ""Tissue""}]"	train
Treatment involved intravitreal injection of bevacizumab ( 1. 25 mg in 0. 05 mL) every 6 - 12 weeks.	bevacizumab,45,56,Chemical	"[{""token"": ""bevacizumab"", ""start_span"": 45, ""end_span"": 56, ""type"": ""Chemical""}]"	train
Treatment was discontinued at patient request or if there was no measurable response to therapy.	patient,30,37,Organism	"[{""token"": ""patient"", ""start_span"": 30, ""end_span"": 37, ""type"": ""Organism""}]"	train
Main outcome measures included best corrected visual acuity, ophthalmic examination, retinal photography, and angiography.	retinal,85,92,Multi	"[{""token"": ""retinal"", ""start_span"": 85, ""end_span"": 92, ""type"": ""Multi""}]"	train
Three patients discontinued therapy.	patients,6,14,Organism	"[{""token"": ""patients"", ""start_span"": 6, ""end_span"": 14, ""type"": ""Organism""}]"	train
Three patients ( 14%) regained 2 or more lines of visual acuity.	patients,6,14,Organism	"[{""token"": ""patients"", ""start_span"": 6, ""end_span"": 14, ""type"": ""Organism""}]"	train
No ocular or systemic bevacizumab - related side effects were observed.	bevacizumab,22,33,Chemical	"[{""token"": ""bevacizumab"", ""start_span"": 22, ""end_span"": 33, ""type"": ""Chemical""}]"	train
CONCLUSIONS: Intravitreal bevacizumab can be used to treat radiation retinopathy.	bevacizumab,26,37,Chemical	"[{""token"": ""bevacizumab"", ""start_span"": 26, ""end_span"": 37, ""type"": ""Chemical""}]"	train
In most cases treatment was associated with decreased vascular leakage, stabilization, or improved vision.	vascular,54,62,Multi	"[{""token"": ""vascular"", ""start_span"": 54, ""end_span"": 62, ""type"": ""Multi""}]"	train
A novel putative tyrosine kinase receptor with oncogenic potential.	tyrosine,17,25,Amino_acid	"[{""token"": ""tyrosine"", ""start_span"": 17, ""end_span"": 25, ""type"": ""Amino_acid""}]"	train
Here, we report the cDNA cloning of the corresponding oncogene, designated UFO, in allusion to the as yet unidentified function of its protein.	UFO,75,78,Gene_or_gene_product	"[{""token"": ""UFO"", ""start_span"": 75, ""end_span"": 78, ""type"": ""Gene_or_gene_product""}]"	train
The UFO locus is evolutionarily conserved between vertebrate species.	UFO,4,7,Gene_or_gene_product	"[{""token"": ""UFO"", ""start_span"": 4, ""end_span"": 7, ""type"": ""Gene_or_gene_product""}]"	train
We thus have identified a novel element of the complex signaling network involved in the control of cell proliferation and differentiation.	cell,100,104,Cell	"[{""token"": ""cell"", ""start_span"": 100, ""end_span"": 104, ""type"": ""Cell""}]"	train
DESIGN: Differentially expressed proteins discovered between the two cell lines were identified by mass spectrometry.	cell lines,69,79,Cell	"[{""token"": ""cell lines"", ""start_span"": 69, ""end_span"": 79, ""type"": ""Cell""}]"	train
Proprotein convertases are serine endoproteases implicated in the proteolytic processing of a large variety of regulatory proteins.	serine,27,33,Amino_acid	"[{""token"": ""serine"", ""start_span"": 27, ""end_span"": 33, ""type"": ""Amino_acid""}]"	train
The transition between both conformations contributes to the control of glycolysis and is important for tumor cell proliferation and survival.	tumor cell,104,114,Cell	"[{""token"": ""tumor cell"", ""start_span"": 104, ""end_span"": 114, ""type"": ""Cell""}]"	train
CONCLUSIONS: ITCs circulate even in early stages of disease.	ITCs,13,17,Cell	"[{""token"": ""ITCs"", ""start_span"": 13, ""end_span"": 17, ""type"": ""Cell""}]"	train
Hepatectomy was performed, and the patient is alive and free of disease 1 year postsurgery.	patient,35,42,Organism	"[{""token"": ""patient"", ""start_span"": 35, ""end_span"": 42, ""type"": ""Organism""}]"	train
Contemporary perspectives on vital pulp therapy: views from the endodontists and pediatric dentists.	pulp,35,39,Tissue	"[{""token"": ""pulp"", ""start_span"": 35, ""end_span"": 39, ""type"": ""Tissue""}]"	train
The purpose of this study was to determine the level of agreement between pediatric dentists and endodontists at a pulp therapy symposium conjointly sponsored by the American Association of Endodontists ( AAE) and the American Academy of Pediatric Dentistry ( AAPD) on November 2 - 3, 2007.	pulp,115,119,Tissue	"[{""token"": ""pulp"", ""start_span"": 115, ""end_span"": 119, ""type"": ""Tissue""}]"	train
Both groups believe that pulp revascularization and regeneration will be viable treatment modalities in the future.	pulp,25,29,Tissue	"[{""token"": ""pulp"", ""start_span"": 25, ""end_span"": 29, ""type"": ""Tissue""}]"	train
The AAE and the AAPD are positioned to begin preparation of best practice guidelines that share common language and treatment recommendations for pulp therapies performed by both specialties.	pulp,146,150,Tissue	"[{""token"": ""pulp"", ""start_span"": 146, ""end_span"": 150, ""type"": ""Tissue""}]"	train
Therefore, high TP is most likely associated with a poor prognosis.	TP,16,18,Gene_or_gene_product	"[{""token"": ""TP"", ""start_span"": 16, ""end_span"": 18, ""type"": ""Gene_or_gene_product""}]"	train
Regulation of the Warburg effect in early - passage breast cancer cells.	early - passage breast cancer cells,36,71,Cell	"[{""token"": ""early - passage breast cancer cells"", ""start_span"": 36, ""end_span"": 71, ""type"": ""Cell""}]"	train
No correlations were observed between glycolytic rates and pAkt levels.	pAkt,59,63,Gene_or_gene_product	"[{""token"": ""pAkt"", ""start_span"": 59, ""end_span"": 63, ""type"": ""Gene_or_gene_product""}]"	train
Promoter binding assay was performed by chromatin immunoprecipitation ( ChIP) assay.	chromatin,40,49,Cellular_component	"[{""token"": ""chromatin"", ""start_span"": 40, ""end_span"": 49, ""type"": ""Cellular_component""}]"	train
Integrin alpha5beta1 immobilized on a ProteoChip was used to screen new antagonistic peptides from multiple hexapeptide sub - libraries of the positional scanning synthetic peptide combinatorial library ( PS - SPCL).	Integrin alpha5beta1,0,20,Gene_or_gene_product	"[{""token"": ""Integrin alpha5beta1"", ""start_span"": 0, ""end_span"": 20, ""type"": ""Gene_or_gene_product""}]"	train
These results suggest that A5 - 1 will be a potent inhibitor of neovascularization.	A5 - 1,27,33,Gene_or_gene_product	"[{""token"": ""A5 - 1"", ""start_span"": 27, ""end_span"": 33, ""type"": ""Gene_or_gene_product""}]"	train
Our group seeks to determine the basic mechanisms underlying ES wound therapy, an area where understanding is currently limited.	wound,64,69,Pathological_formation	"[{""token"": ""wound"", ""start_span"": 64, ""end_span"": 69, ""type"": ""Pathological_formation""}]"	train
A standardized surgical procedure incorporated a hybrid stimulation system comprising an implantable mini - stimulator and surface electrodes, with creation of repeatable ischemic wounds.	wounds,180,186,Pathological_formation	"[{""token"": ""wounds"", ""start_span"": 180, ""end_span"": 186, ""type"": ""Pathological_formation""}]"	train
Twenty mature male New Zealand white rabbits ( 3 kg weight) were employed to evaluate the effects of two empirically selected stimulation paradigms applied continuously for 7 - 21 days, using each animal as its own control.	rabbits,37,44,Organism	"[{""token"": ""rabbits"", ""start_span"": 37, ""end_span"": 44, ""type"": ""Organism""}]"	train
All wounds were fully re - epithelialized by 10 days post - injury.	wounds,4,10,Pathological_formation	"[{""token"": ""wounds"", ""start_span"": 4, ""end_span"": 10, ""type"": ""Pathological_formation""}]"	train
Recently, there is an increasing number of patents which have been focused on the inhibitors of VEGF action.	VEGF,96,100,Gene_or_gene_product	"[{""token"": ""VEGF"", ""start_span"": 96, ""end_span"": 100, ""type"": ""Gene_or_gene_product""}]"	train
We will also discuss several patents regarding inhibitors of VEGF action in the present review.	VEGF,61,65,Gene_or_gene_product	"[{""token"": ""VEGF"", ""start_span"": 61, ""end_span"": 65, ""type"": ""Gene_or_gene_product""}]"	train
METHODS: MSCs from Sprague - Dawley ( SD) rats were isolated and cultured in vitro.	MSCs,9,13,Cell	"[{""token"": ""MSCs"", ""start_span"": 9, ""end_span"": 13, ""type"": ""Cell""}]"	train
The apoptosis characteristics of MSCs were observed under conditions of ischemia and anoxia.	MSCs,33,37,Cell	"[{""token"": ""MSCs"", ""start_span"": 33, ""end_span"": 37, ""type"": ""Cell""}]"	train
The correlation between the expression of COUP - TFII and clinicopathologic features was investigated.	COUP - TFII,42,53,Gene_or_gene_product	"[{""token"": ""COUP - TFII"", ""start_span"": 42, ""end_span"": 53, ""type"": ""Gene_or_gene_product""}]"	train
The methylation status was correlated to the clinical manifestations and to PTEN expression, which was analyzed by both Western blot and immunohistochemistry.	PTEN,76,80,Gene_or_gene_product	"[{""token"": ""PTEN"", ""start_span"": 76, ""end_span"": 80, ""type"": ""Gene_or_gene_product""}]"	train
BACKGROUND: Aberrant angiogenesis is a landmark feature in cancer, which is important for proliferation, growth and metastasis, and is mediated by various pro - angiogenic factors.	cancer,59,65,Cancer	"[{""token"": ""cancer"", ""start_span"": 59, ""end_span"": 65, ""type"": ""Cancer""}]"	train
The VEGF pathway is one of the most important and best - studied angiogenic pathways.	VEGF,4,8,Gene_or_gene_product	"[{""token"": ""VEGF"", ""start_span"": 4, ""end_span"": 8, ""type"": ""Gene_or_gene_product""}]"	train
RESULTS: Aflibercept was shown to have early clinical activity.	Aflibercept,9,20,Chemical	"[{""token"": ""Aflibercept"", ""start_span"": 9, ""end_span"": 20, ""type"": ""Chemical""}]"	train
Media supplemented with and without 10% Oxygent were compared in all assessments.	Oxygent,40,47,Chemical	"[{""token"": ""Oxygent"", ""start_span"": 40, ""end_span"": 47, ""type"": ""Chemical""}]"	train
METHODS: From June 2004 to December 2007, 132 patients received diagnosis and treatment in our hospital.	patients,46,54,Organism	"[{""token"": ""patients"", ""start_span"": 46, ""end_span"": 54, ""type"": ""Organism""}]"	train
Antioxidants significantly reduced TNFalpha - induced genetic damage.	TNFalpha,35,43,Gene_or_gene_product	"[{""token"": ""TNFalpha"", ""start_span"": 35, ""end_span"": 43, ""type"": ""Gene_or_gene_product""}]"	train
Therefore, genetic instability plays an important role in inflammation - associated cancers.	cancers,84,91,Cancer	"[{""token"": ""cancers"", ""start_span"": 84, ""end_span"": 91, ""type"": ""Cancer""}]"	train
Little is known about the metabolic adaptation of endothelial cells through such a transformation.	endothelial cells,50,67,Cell	"[{""token"": ""endothelial cells"", ""start_span"": 50, ""end_span"": 67, ""type"": ""Cell""}]"	train
In this regard, inhibitors of these pathways have been shown to be effective antitumoral agents.	antitumoral,77,88,Cancer	"[{""token"": ""antitumoral"", ""start_span"": 77, ""end_span"": 88, ""type"": ""Cancer""}]"	train
However, mechanism ( s) by which VEGFR2 signaling and trafficking is coordinated are not clear.	VEGFR2,33,39,Gene_or_gene_product	"[{""token"": ""VEGFR2"", ""start_span"": 33, ""end_span"": 39, ""type"": ""Gene_or_gene_product""}]"	train
Bmi - 1 over - expression therefore has more pronounced effects in culture and does not appear to be sufficient to induce tumorigenesis in vivo.	Bmi - 1,0,7,Gene_or_gene_product	"[{""token"": ""Bmi - 1"", ""start_span"": 0, ""end_span"": 7, ""type"": ""Gene_or_gene_product""}]"	train
In breast cancer, biomarkers that specifically correlate with the invasive phenotypes have not been clearly identified.	breast cancer,3,16,Cancer	"[{""token"": ""breast cancer"", ""start_span"": 3, ""end_span"": 16, ""type"": ""Cancer""}]"	train
Overexpression of these proteins is independent of the transcriptional upregulation of their genes, and occurs only in highly malignant breast cancer cells.	malignant breast cancer cells,126,155,Cell	"[{""token"": ""malignant breast cancer cells"", ""start_span"": 126, ""end_span"": 155, ""type"": ""Cell""}]"	train
Microenvironments have been highly implicated in the malignancy of mammary tumors.	mammary tumors,67,81,Cancer	"[{""token"": ""mammary tumors"", ""start_span"": 67, ""end_span"": 81, ""type"": ""Cancer""}]"	train
Possible translation of our knowledge to cancer therapeutics will also be discussed.	cancer,41,47,Cancer	"[{""token"": ""cancer"", ""start_span"": 41, ""end_span"": 47, ""type"": ""Cancer""}]"	train
While many genetic alterations have been identified in melanoma, the relevant molecular events that contribute to disease progression are poorly understood.	melanoma,55,63,Cancer	"[{""token"": ""melanoma"", ""start_span"": 55, ""end_span"": 63, ""type"": ""Cancer""}]"	train
AngiomiRs - - key regulators of angiogenesis.	AngiomiRs,0,9,Gene_or_gene_product	"[{""token"": ""AngiomiRs"", ""start_span"": 0, ""end_span"": 9, ""type"": ""Gene_or_gene_product""}]"	train
Aberrant angiogenesis leads to a variety of diseases, such as ischemia and cancer.	cancer,75,81,Cancer	"[{""token"": ""cancer"", ""start_span"": 75, ""end_span"": 81, ""type"": ""Cancer""}]"	train
Specific miRNAs ( angiomiRs) have recently been shown to regulate angiogenesis in vivo.	angiomiRs,18,27,Gene_or_gene_product	"[{""token"": ""angiomiRs"", ""start_span"": 18, ""end_span"": 27, ""type"": ""Gene_or_gene_product""}]"	train
Manipulating angiomiRs in the settings of pathological vascularization represents a new therapeutic approach.	angiomiRs,13,22,Gene_or_gene_product	"[{""token"": ""angiomiRs"", ""start_span"": 13, ""end_span"": 22, ""type"": ""Gene_or_gene_product""}]"	train
Moreover, outward growth migration model and transwell chamber assay were used to detect ECs migration.	ECs,89,92,Cell	"[{""token"": ""ECs"", ""start_span"": 89, ""end_span"": 92, ""type"": ""Cell""}]"	train
CONCLUSIONS: Our study provides new candidate genes for the esophageal cancer microenvironment.	esophageal cancer,60,77,Cancer	"[{""token"": ""esophageal cancer"", ""start_span"": 60, ""end_span"": 77, ""type"": ""Cancer""}]"	train
There is evidence for the implication of ARF in angiogenesis.	ARF,41,44,Gene_or_gene_product	"[{""token"": ""ARF"", ""start_span"": 41, ""end_span"": 44, ""type"": ""Gene_or_gene_product""}]"	train
However, the exact mechanisms of ARF action yet remain unclear and require further studies by different specialists at both the molecular genetic and other levels of investigation.	ARF,33,36,Gene_or_gene_product	"[{""token"": ""ARF"", ""start_span"": 33, ""end_span"": 36, ""type"": ""Gene_or_gene_product""}]"	train
Smooth muscle - rich tissues respond to mechanical overload by an adaptive hypertrophic growth combined with activation of angiogenesis, which potentiates their mechanical overload - bearing capabilities.	Smooth muscle - rich tissues,0,28,Tissue	"[{""token"": ""Smooth muscle - rich tissues"", ""start_span"": 0, ""end_span"": 28, ""type"": ""Tissue""}]"	train
Angiogenesis in platelet endothelial cell adhesion molecule - 1 - null mice.	platelet endothelial cell adhesion molecule - 1,16,63,Gene_or_gene_product	"[{""token"": ""platelet endothelial cell adhesion molecule - 1"", ""start_span"": 16, ""end_span"": 63, ""type"": ""Gene_or_gene_product""}]"	train
Consequently, cells were more rigid and show reduced motility.	cells,14,19,Cell	"[{""token"": ""cells"", ""start_span"": 14, ""end_span"": 19, ""type"": ""Cell""}]"	train
PURPOSE: Antiangiogenic therapy is considered as an effective strategy for controlling the growth and metastasis of tumors.	tumors,116,122,Cancer	"[{""token"": ""tumors"", ""start_span"": 116, ""end_span"": 122, ""type"": ""Cancer""}]"	train
Our results suggest that EPOX is a novel antiangiogenic agent, making it a promising lead compound for further development in the treatment of angiogenesis - related pathologies.	EPOX,25,29,Chemical	"[{""token"": ""EPOX"", ""start_span"": 25, ""end_span"": 29, ""type"": ""Chemical""}]"	train
Targeting angiogenesis: progress with anti - VEGF treatment with large molecules.	anti - VEGF,38,49,Gene_or_gene_product	"[{""token"": ""anti - VEGF"", ""start_span"": 38, ""end_span"": 49, ""type"": ""Gene_or_gene_product""}]"	train
Angiogenesis - - one of the hallmarks of cancer - - has emerged as a valid therapeutic target in oncology.	cancer,41,47,Cancer	"[{""token"": ""cancer"", ""start_span"": 41, ""end_span"": 47, ""type"": ""Cancer""}]"	train
This Review will discuss the rationale for using antiangiogenic compounds and will focus on large molecules, such as antibodies, that target the VEGF system.	VEGF,145,149,Gene_or_gene_product	"[{""token"": ""VEGF"", ""start_span"": 145, ""end_span"": 149, ""type"": ""Gene_or_gene_product""}]"	train
Clinical data on bevacizumab is discussed in detail.	bevacizumab,17,28,Chemical	"[{""token"": ""bevacizumab"", ""start_span"": 17, ""end_span"": 28, ""type"": ""Chemical""}]"	train
[ Ambiguity role of neutrophils in oncogenesis]	neutrophils,20,31,Cell	"[{""token"": ""neutrophils"", ""start_span"": 20, ""end_span"": 31, ""type"": ""Cell""}]"	train
The special attention is focused on the ambiguity of the neutrophil role in oncogenesis.	neutrophil,57,67,Cell	"[{""token"": ""neutrophil"", ""start_span"": 57, ""end_span"": 67, ""type"": ""Cell""}]"	train
These data confirm the importance of tissue architecture and polarity in malignant progression.	tissue,37,43,Tissue	"[{""token"": ""tissue"", ""start_span"": 37, ""end_span"": 43, ""type"": ""Tissue""}]"	train
Metronomic chemotherapy ( the frequent, long term, low dose administration of chemotherapeutic drugs) is a promising therapy because it enhances the anti - endothelial activity of conventional chemotherapeutics, but with lower or no toxic effects compared to maximum tolerated dose administration.	endothelial,156,167,Cell	"[{""token"": ""endothelial"", ""start_span"": 156, ""end_span"": 167, ""type"": ""Cell""}]"	train
The metronomic concept might not universally apply to every cytotoxic drug in colorectal cancer and metronomic combination regimens should be used with caution.	colorectal cancer,78,95,Cancer	"[{""token"": ""colorectal cancer"", ""start_span"": 78, ""end_span"": 95, ""type"": ""Cancer""}]"	train
A key role for the integrin alpha2beta1 in experimental and developmental angiogenesis.	integrin alpha2beta1,19,39,Gene_or_gene_product	"[{""token"": ""integrin alpha2beta1"", ""start_span"": 19, ""end_span"": 39, ""type"": ""Gene_or_gene_product""}]"	train
The alpha2beta1 integrin receptor plays a key role in angiogenesis.	alpha2beta1 integrin receptor,4,33,Gene_or_gene_product	"[{""token"": ""alpha2beta1 integrin receptor"", ""start_span"": 4, ""end_span"": 33, ""type"": ""Gene_or_gene_product""}]"	train
Collectively, our results provide strong biochemical and genetic evidence of a central role for alpha2beta1 integrin in experimental and developmental angiogenesis.	alpha2beta1 integrin,96,116,Gene_or_gene_product	"[{""token"": ""alpha2beta1 integrin"", ""start_span"": 96, ""end_span"": 116, ""type"": ""Gene_or_gene_product""}]"	train
Angiogenesis has an essential role in promoting and supporting tumor growth and it is an important therapeutic target.	tumor,63,68,Cancer	"[{""token"": ""tumor"", ""start_span"": 63, ""end_span"": 68, ""type"": ""Cancer""}]"	train
Hence orally active blockers of TNF - alpha that are safe, efficacious and inexpensive are urgently needed.	TNF - alpha,32,43,Gene_or_gene_product	"[{""token"": ""TNF - alpha"", ""start_span"": 32, ""end_span"": 43, ""type"": ""Gene_or_gene_product""}]"	train
Cotreatment of cell lines with a hormone and its specific antagonist blocked the effect of the hormone.	cell lines,15,25,Cell	"[{""token"": ""cell lines"", ""start_span"": 15, ""end_span"": 25, ""type"": ""Cell""}]"	train
Our results confirm a close link between the two metabolic enzymes and indicate an alteration in the glucose metabolism in the process of malignant transformation.	glucose,101,108,Chemical	"[{""token"": ""glucose"", ""start_span"": 101, ""end_span"": 108, ""type"": ""Chemical""}]"	train
These models may have clinically relevant implications, particularly for the tailoring of therapeutic strategies targeting telomerase.	telomerase,123,133,Gene_or_gene_product	"[{""token"": ""telomerase"", ""start_span"": 123, ""end_span"": 133, ""type"": ""Gene_or_gene_product""}]"	train
Cell invasion and apoptosis assays were also performed.	Cell,0,4,Cell	"[{""token"": ""Cell"", ""start_span"": 0, ""end_span"": 4, ""type"": ""Cell""}]"	train
We also report on the identification of novel RASSF1C target genes.	RASSF1C,46,53,Gene_or_gene_product	"[{""token"": ""RASSF1C"", ""start_span"": 46, ""end_span"": 53, ""type"": ""Gene_or_gene_product""}]"	train
BACKGROUND: Recently, the desmoplastic reaction has been implicated as having an important function in epithelial solid tumor biology.	epithelial solid tumor,103,125,Cancer	"[{""token"": ""epithelial solid tumor"", ""start_span"": 103, ""end_span"": 125, ""type"": ""Cancer""}]"	train
The purpose of this study was to immunohistochemically investigate the correlation between the desmoplastic reaction and the clinicopathology of invasive breast cancer.	breast cancer,154,167,Cancer	"[{""token"": ""breast cancer"", ""start_span"": 154, ""end_span"": 167, ""type"": ""Cancer""}]"	train
After staining samples for alpha - SMA, their expression was extracted and quantified as a relative percentage by computer - assisted image analysis.	alpha - SMA,27,38,Gene_or_gene_product	"[{""token"": ""alpha - SMA"", ""start_span"": 27, ""end_span"": 38, ""type"": ""Gene_or_gene_product""}]"	train
RESULTS: There was relatively wide variation in the expression of alpha - SMA with the percentage of the area from 0. 68 to 28. 15% ( mean 8. 48 + / - 5. 40%).	alpha - SMA,66,77,Gene_or_gene_product	"[{""token"": ""alpha - SMA"", ""start_span"": 66, ""end_span"": 77, ""type"": ""Gene_or_gene_product""}]"	train
The metastasis group showed significantly higher alpha - SMA expression compared with the no metastasis group ( p < 0. 001).	alpha - SMA,49,60,Gene_or_gene_product	"[{""token"": ""alpha - SMA"", ""start_span"": 49, ""end_span"": 60, ""type"": ""Gene_or_gene_product""}]"	train
In recent years the family of ADAM proteases has been ascribed important roles in these processes.	ADAM,30,34,Gene_or_gene_product	"[{""token"": ""ADAM"", ""start_span"": 30, ""end_span"": 34, ""type"": ""Gene_or_gene_product""}]"	train
Emerging metabolic targets in cancer therapy.	cancer,30,36,Cancer	"[{""token"": ""cancer"", ""start_span"": 30, ""end_span"": 36, ""type"": ""Cancer""}]"	train
"This altered energy dependency is known as the "" Warburg effect "" and is a hallmark of cancer cells."	cancer cells,87,99,Cell	"[{""token"": ""cancer cells"", ""start_span"": 87, ""end_span"": 99, ""type"": ""Cell""}]"	train
Emerging evidence shows that oncogenes that drive the cancer - promoting signals also drive the altered metabolism.	cancer,54,60,Cancer	"[{""token"": ""cancer"", ""start_span"": 54, ""end_span"": 60, ""type"": ""Cancer""}]"	train
Although the exact mechanisms underlying the Warburg effect are unclear, the existing evidence suggests that increased glycolysis plays an important role in support malignant behavior of cancer cells.	cancer cells,187,199,Cell	"[{""token"": ""cancer cells"", ""start_span"": 187, ""end_span"": 199, ""type"": ""Cell""}]"	train
Such evidence indicates that MTSS1 as a multiple functional molecular player and has an important role in development, carcinogenesis and metastasis.	MTSS1,29,34,Gene_or_gene_product	"[{""token"": ""MTSS1"", ""start_span"": 29, ""end_span"": 34, ""type"": ""Gene_or_gene_product""}]"	train
The clinical significance of MTSS1 will also be discussed.	MTSS1,29,34,Gene_or_gene_product	"[{""token"": ""MTSS1"", ""start_span"": 29, ""end_span"": 34, ""type"": ""Gene_or_gene_product""}]"	train
sVAP - 1 levels were assayed by enzyme - linked immunosorbent assay.	sVAP - 1,0,8,Gene_or_gene_product	"[{""token"": ""sVAP - 1"", ""start_span"": 0, ""end_span"": 8, ""type"": ""Gene_or_gene_product""}]"	train
Metabolic regulation by p53.	p53,24,27,Gene_or_gene_product	"[{""token"": ""p53"", ""start_span"": 24, ""end_span"": 27, ""type"": ""Gene_or_gene_product""}]"	train
The ability to positively and negatively regulate many of these pathways, combined with feedback signalling from these pathways to p53, demonstrates the reciprocal and flexible nature of the regulation, facilitating a diverse range of responses to metabolic stress.	p53,131,134,Gene_or_gene_product	"[{""token"": ""p53"", ""start_span"": 131, ""end_span"": 134, ""type"": ""Gene_or_gene_product""}]"	train
DNA microarray analysis and small animal PET studies may be used as complementary technologies in drug development.	DNA,0,3,Cellular_component	"[{""token"": ""DNA"", ""start_span"": 0, ""end_span"": 3, ""type"": ""Cellular_component""}]"	train
These HCC cell lines had a similar genetic background but with an increasing potential of metastasis.	HCC cell lines,6,20,Cell	"[{""token"": ""HCC cell lines"", ""start_span"": 6, ""end_span"": 20, ""type"": ""Cell""}]"	train
Using a combination of two dimensional electrophoresis ( 2 - DE) and MALDI - TOF mass spectrometry, a total of 125 proteins and their post - translational modification forms or isoforms were found to be differentially expressed in the cell lines.	cell lines,235,245,Cell	"[{""token"": ""cell lines"", ""start_span"": 235, ""end_span"": 245, ""type"": ""Cell""}]"	train
This work provides a demonstration that a combination of bioinformatics and comparative proteomics can help in finding out potential biomarkers associated with HCC metastasis on the level of pathways.	HCC,160,163,Cancer	"[{""token"": ""HCC"", ""start_span"": 160, ""end_span"": 163, ""type"": ""Cancer""}]"	train
Therefore, this enhancing effect does not result from an idiosyncrasy of the EBV genome but rather reflects a general property of these miRNAs.	EBV,77,80,Organism	"[{""token"": ""EBV"", ""start_span"": 77, ""end_span"": 80, ""type"": ""Organism""}]"	train
The cells invasion was demonstrated by transwell assay.	cells,4,9,Cell	"[{""token"": ""cells"", ""start_span"": 4, ""end_span"": 9, ""type"": ""Cell""}]"	train
Cytokines play an important role in creating an inflammatory microenvironment, which is now considered a hallmark of cancer.	cancer,117,123,Cancer	"[{""token"": ""cancer"", ""start_span"": 117, ""end_span"": 123, ""type"": ""Cancer""}]"	train
Human T - cell lymphoma virus ( HTLV) - 1 was the first human retrovirus to be discovered.	human,56,61,Organism	"[{""token"": ""human"", ""start_span"": 56, ""end_span"": 61, ""type"": ""Organism""}]"	train
Malignant melanoma is characterized by frequent metastasis, however, specific changes that regulate this process have not been clearly delineated.	Malignant melanoma,0,18,Cancer	"[{""token"": ""Malignant melanoma"", ""start_span"": 0, ""end_span"": 18, ""type"": ""Cancer""}]"	train
Cell proliferation in each sample was assessed by using the Ki - 67 proliferation marker.	Cell,0,4,Cell	"[{""token"": ""Cell"", ""start_span"": 0, ""end_span"": 4, ""type"": ""Cell""}]"	train
A similar result was observed in invasive carcinomas ( 0 / 12).	invasive carcinomas,33,52,Cancer	"[{""token"": ""invasive carcinomas"", ""start_span"": 33, ""end_span"": 52, ""type"": ""Cancer""}]"	train
The most intense immunoreactivity was observed in branching capillaries.	capillaries,60,71,Tissue	"[{""token"": ""capillaries"", ""start_span"": 60, ""end_span"": 71, ""type"": ""Tissue""}]"	train
Endothelial cell staining was heterogeneous and varied in different regions.	Endothelial cell,0,16,Cell	"[{""token"": ""Endothelial cell"", ""start_span"": 0, ""end_span"": 16, ""type"": ""Cell""}]"	train
Overexpression confers an oncogenic potential upon the eph gene.	eph,55,58,Gene_or_gene_product	"[{""token"": ""eph"", ""start_span"": 55, ""end_span"": 58, ""type"": ""Gene_or_gene_product""}]"	train
From 35 to 100% of the whole amount of ATP resynthesized via glycolysis is utilized for transport purposes.	ATP,39,42,Chemical	"[{""token"": ""ATP"", ""start_span"": 39, ""end_span"": 42, ""type"": ""Chemical""}]"	train
[ Tumor metastasis and the fibrinolytic system].	Tumor,2,7,Cancer	"[{""token"": ""Tumor"", ""start_span"": 2, ""end_span"": 7, ""type"": ""Cancer""}]"	train
Metastatic spread of malignant tumor appears to correlate with activation of the fibrolytic system.	malignant tumor,21,36,Cancer	"[{""token"": ""malignant tumor"", ""start_span"": 21, ""end_span"": 36, ""type"": ""Cancer""}]"	train
However, development of consumption coagulopathy characterized by progression from hypercoagulable state to disseminated intravascular coagulation has also been found in several cases.	intravascular,121,134,Immaterial_anatomical_entity	"[{""token"": ""intravascular"", ""start_span"": 121, ""end_span"": 134, ""type"": ""Immaterial_anatomical_entity""}]"	train
We have suggested that constitutive activation of this kinase is one mechanism by which oncogenes transform cells.	cells,108,113,Cell	"[{""token"": ""cells"", ""start_span"": 108, ""end_span"": 113, ""type"": ""Cell""}]"	train
Surprisingly, however, further phosphorylation of this protein on addition of phorbol ester was greatly reduced.	phorbol ester,78,91,Chemical	"[{""token"": ""phorbol ester"", ""start_span"": 78, ""end_span"": 91, ""type"": ""Chemical""}]"	train
Epidermal growth factor and its receptor.	Epidermal growth factor,0,23,Gene_or_gene_product	"[{""token"": ""Epidermal growth factor"", ""start_span"": 0, ""end_span"": 23, ""type"": ""Gene_or_gene_product""}]"	train
Synthesis and degradation of the EGF receptor are regulated, in addition, covalent modification by phosphorylation regulates activity of the receptor protein.	EGF receptor,33,45,Gene_or_gene_product	"[{""token"": ""EGF receptor"", ""start_span"": 33, ""end_span"": 45, ""type"": ""Gene_or_gene_product""}]"	train
Intramolecular self - phosphorylation of Tyr1173 removes a competitive inhibitory constraint to enhance phosphorylation of substrates.	Tyr1173,41,48,Amino_acid	"[{""token"": ""Tyr1173"", ""start_span"": 41, ""end_span"": 48, ""type"": ""Amino_acid""}]"	train
However, the maximum decrease approached 100% in stationary cultures versus approximately 75% in growing cells.	cells,105,110,Cell	"[{""token"": ""cells"", ""start_span"": 105, ""end_span"": 110, ""type"": ""Cell""}]"	train
The specific enhancement of tumor proliferation in vitro.	tumor,28,33,Cancer	"[{""token"": ""tumor"", ""start_span"": 28, ""end_span"": 33, ""type"": ""Cancer""}]"	train
The existence of proteins encoded by the 3 ' region has been postulated on the basis of multiple open reading frames.	3 ' region,41,51,Cellular_component	"[{""token"": ""3 ' region"", ""start_span"": 41, ""end_span"": 51, ""type"": ""Cellular_component""}]"	train
The genetics of transformation by SV 40.	SV 40,34,39,Organism	"[{""token"": ""SV 40"", ""start_span"": 34, ""end_span"": 39, ""type"": ""Organism""}]"	train
The increased transport rate is a consequence of an increased number of transporters in the transformed cells.	cells,104,109,Cell	"[{""token"": ""cells"", ""start_span"": 104, ""end_span"": 109, ""type"": ""Cell""}]"	train
The lack of expression correlates with a lack of detectable HLA - DR mRNA.	HLA - DR,60,68,Gene_or_gene_product	"[{""token"": ""HLA - DR"", ""start_span"": 60, ""end_span"": 68, ""type"": ""Gene_or_gene_product""}]"	train
This suggests that expression of DR antigens also can be modulated post - transcriptionally.	DR antigens,33,44,Gene_or_gene_product	"[{""token"": ""DR antigens"", ""start_span"": 33, ""end_span"": 44, ""type"": ""Gene_or_gene_product""}]"	train
Lewis lung carcinoma.	Lewis lung carcinoma,0,20,Cancer	"[{""token"": ""Lewis lung carcinoma"", ""start_span"": 0, ""end_span"": 20, ""type"": ""Cancer""}]"	train
Metabolic alterations in a noncachectic animal tumor system.	tumor,47,52,Cancer	"[{""token"": ""tumor"", ""start_span"": 47, ""end_span"": 52, ""type"": ""Cancer""}]"	train
The effects of 3 - mercaptopicolinic acid, a potent inhibitor of gluconeogenesis, was also examined on this model.	3 - mercaptopicolinic acid,15,41,Chemical	"[{""token"": ""3 - mercaptopicolinic acid"", ""start_span"": 15, ""end_span"": 41, ""type"": ""Chemical""}]"	train
The portion of the LTR responsible for trans activation was mapped by deletions to lie within the U3 region.	LTR,19,22,Cellular_component	"[{""token"": ""LTR"", ""start_span"": 19, ""end_span"": 22, ""type"": ""Cellular_component""}]"	train
2G7 transiently inhibited growth of established MDA - 231 subcutaneous tumors.	MDA - 231 subcutaneous tumors,48,77,Cancer	"[{""token"": ""MDA - 231 subcutaneous tumors"", ""start_span"": 48, ""end_span"": 77, ""type"": ""Cancer""}]"	train
Histologically, both 2G7 - treated and control tumors were identical.	tumors,47,53,Cancer	"[{""token"": ""tumors"", ""start_span"": 47, ""end_span"": 53, ""type"": ""Cancer""}]"	train
Nevertheless, for both viruses the leukemic blasts retained full factor dependence for growth.	leukemic blasts,35,50,Cell	"[{""token"": ""leukemic blasts"", ""start_span"": 35, ""end_span"": 50, ""type"": ""Cell""}]"	train
To evaluate the ability of AdCMV. VEGF165 to function in vivo, either AdCMV.	VEGF165,34,41,Gene_or_gene_product	"[{""token"": ""VEGF165"", ""start_span"": 34, ""end_span"": 41, ""type"": ""Gene_or_gene_product""}]"	train
The latter effect persisted even with the late addition of CHX.	CHX,59,62,Chemical	"[{""token"": ""CHX"", ""start_span"": 59, ""end_span"": 62, ""type"": ""Chemical""}]"	train
The conclusion most consistent with the data is that the two MSRs are overlapping, spliced RNAs.	MSRs,61,65,Gene_or_gene_product	"[{""token"": ""MSRs"", ""start_span"": 61, ""end_span"": 65, ""type"": ""Gene_or_gene_product""}]"	train
Both small RNAs contain a latency promoter binding factor consensus recognition sequence located toward their 5 ' ends as well as two potential ICP4 recognition consensus sequences, one in each orientation.	ICP4,144,148,Gene_or_gene_product	"[{""token"": ""ICP4"", ""start_span"": 144, ""end_span"": 148, ""type"": ""Gene_or_gene_product""}]"	train
The region contains a number of small open reading frames on each side and within the MSRs.	MSRs,86,90,Gene_or_gene_product	"[{""token"": ""MSRs"", ""start_span"": 86, ""end_span"": 90, ""type"": ""Gene_or_gene_product""}]"	train
Although the exact endpoints are unknown, the large 10 - kb species spans the entire ICP4 homolog region.	ICP4 homolog,85,97,Gene_or_gene_product	"[{""token"": ""ICP4 homolog"", ""start_span"": 85, ""end_span"": 97, ""type"": ""Gene_or_gene_product""}]"	train
After 2 h incubation at 37 degrees C the drop in the ATP level was lower.	ATP,53,56,Chemical	"[{""token"": ""ATP"", ""start_span"": 53, ""end_span"": 56, ""type"": ""Chemical""}]"	train
Their relevance in cancer prevention.	cancer,19,25,Cancer	"[{""token"": ""cancer"", ""start_span"": 19, ""end_span"": 25, ""type"": ""Cancer""}]"	train
This hypothesis in humans can be tested only by intervention trials that are in progress.	humans,19,25,Organism	"[{""token"": ""humans"", ""start_span"": 19, ""end_span"": 25, ""type"": ""Organism""}]"	train
These are exciting new functions of vitamins that nobody could have predicted only a few years ago.	vitamins,36,44,Chemical	"[{""token"": ""vitamins"", ""start_span"": 36, ""end_span"": 44, ""type"": ""Chemical""}]"	train
Increases in these mRNA levels were similar in tumors of both low and high metastatic potential.	tumors,47,53,Cancer	"[{""token"": ""tumors"", ""start_span"": 47, ""end_span"": 53, ""type"": ""Cancer""}]"	train
rho genes have been found in both lower and higher eucaryotes.	rho,0,3,Gene_or_gene_product	"[{""token"": ""rho"", ""start_span"": 0, ""end_span"": 3, ""type"": ""Gene_or_gene_product""}]"	train
They code for proteins of 21 kDa, highly conserved in evolution, which belong to the superfamily of ras GTPases.	ras GTPases,100,111,Gene_or_gene_product	"[{""token"": ""ras GTPases"", ""start_span"": 100, ""end_span"": 111, ""type"": ""Gene_or_gene_product""}]"	train
A Whipple procedure led to a complete resolution of these symptoms and a return of an elevated stomatostatin level to normal.	stomatostatin,95,108,Gene_or_gene_product	"[{""token"": ""stomatostatin"", ""start_span"": 95, ""end_span"": 108, ""type"": ""Gene_or_gene_product""}]"	train
The fact that viral or other adjunctive vectors were not required further suggests that secreted gene products may have potential therapeutic utility even when the number of successfully transfected cells remains low.	cells,199,204,Cell	"[{""token"": ""cells"", ""start_span"": 199, ""end_span"": 204, ""type"": ""Cell""}]"	train
We now report that a nearby residue, Thr - 495, also appears to be phosphorylated.	Thr - 495,37,46,Amino_acid	"[{""token"": ""Thr - 495"", ""start_span"": 37, ""end_span"": 46, ""type"": ""Amino_acid""}]"	train
Bilateral central lymphadenectomy was performed in all patients in addition to thyroidectomy.	patients,55,63,Organism	"[{""token"": ""patients"", ""start_span"": 55, ""end_span"": 63, ""type"": ""Organism""}]"	train
Individuals with MEN IIA should therefore undergo early prophylactic thyroidectomy once the diagnosis is confirmed by molecular genetic testing.	MEN IIA,17,24,Cancer	"[{""token"": ""MEN IIA"", ""start_span"": 17, ""end_span"": 24, ""type"": ""Cancer""}]"	train
Here, we investigated the expression of Ets - 1 during reendothelialization.	Ets - 1,40,47,Gene_or_gene_product	"[{""token"": ""Ets - 1"", ""start_span"": 40, ""end_span"": 47, ""type"": ""Gene_or_gene_product""}]"	train
This induction of Ets - 1 may be relevant for reendothelialization by regulating the expression of certain genes.	Ets - 1,18,25,Gene_or_gene_product	"[{""token"": ""Ets - 1"", ""start_span"": 18, ""end_span"": 25, ""type"": ""Gene_or_gene_product""}]"	train
Mechanisms responsible for hyperinvasiveness and resistance to anti - invasive action of TGFbeta.	TGFbeta,89,96,Gene_or_gene_product	"[{""token"": ""TGFbeta"", ""start_span"": 89, ""end_span"": 96, ""type"": ""Gene_or_gene_product""}]"	train
We examined transformation - induced alterations in proliferative and invasive abilities, responses to the invasion and proliferation - regulating growth factor TGFbeta and changes in gene expression for invasion - associated enzymes or enzyme inhibitors.	TGFbeta,161,168,Gene_or_gene_product	"[{""token"": ""TGFbeta"", ""start_span"": 161, ""end_span"": 168, ""type"": ""Gene_or_gene_product""}]"	train
They were also variably resistant to the anti - proliferative and anti - invasive signals from TGFbeta.	TGFbeta,95,102,Gene_or_gene_product	"[{""token"": ""TGFbeta"", ""start_span"": 95, ""end_span"": 102, ""type"": ""Gene_or_gene_product""}]"	train
Homeobox genes in hematopoiesis and leukemogenesis.	Homeobox,0,8,Gene_or_gene_product	"[{""token"": ""Homeobox"", ""start_span"": 0, ""end_span"": 8, ""type"": ""Gene_or_gene_product""}]"	train
The results indicated that exogenous lactate was the major substrate for oxidative metabolism.	lactate,37,44,Chemical	"[{""token"": ""lactate"", ""start_span"": 37, ""end_span"": 44, ""type"": ""Chemical""}]"	train
The molecular basis of this behaviour could be related to different locations for the lactate dehydrogenase isoenzymes, as suggested by their immunohistochemical labelling.	lactate dehydrogenase isoenzymes,86,118,Gene_or_gene_product	"[{""token"": ""lactate dehydrogenase isoenzymes"", ""start_span"": 86, ""end_span"": 118, ""type"": ""Gene_or_gene_product""}]"	train
U - 995 is composed of two single peptides with molecular mass of 10 and 14 kDa, respectively.	U - 995,0,7,Gene_or_gene_product	"[{""token"": ""U - 995"", ""start_span"": 0, ""end_span"": 7, ""type"": ""Gene_or_gene_product""}]"	train
Similar results were also obtained with respect to 5 - FU.	5 - FU,51,57,Chemical	"[{""token"": ""5 - FU"", ""start_span"": 51, ""end_span"": 57, ""type"": ""Chemical""}]"	valid
Angiogenesis is essential for tumor growth and metastasis.	tumor,30,35,Cancer	"[{""token"": ""tumor"", ""start_span"": 30, ""end_span"": 35, ""type"": ""Cancer""}]"	valid
These findings strongly support an enhanced role for this pathway in clear cell carcinomas by regulating angiogenesis and / or lymphangiogenesis.	clear cell carcinomas,69,90,Cancer	"[{""token"": ""clear cell carcinomas"", ""start_span"": 69, ""end_span"": 90, ""type"": ""Cancer""}]"	valid
Consistent with these findings is the induction under hypoxic conditions of the HIF - 1 protein.	HIF - 1,80,87,Gene_or_gene_product	"[{""token"": ""HIF - 1"", ""start_span"": 80, ""end_span"": 87, ""type"": ""Gene_or_gene_product""}]"	valid
BMSVTs exhibited a partially transformed phenotype, demonstrating growth factor independence, altered antigen expression and forming tiny, infrequent colonies in vitro.	BMSVTs,0,6,Cell	"[{""token"": ""BMSVTs"", ""start_span"": 0, ""end_span"": 6, ""type"": ""Cell""}]"	valid
Tumor size was measured every 3 days.	Tumor,0,5,Cancer	"[{""token"": ""Tumor"", ""start_span"": 0, ""end_span"": 5, ""type"": ""Cancer""}]"	valid
In situ fluorescent end labeling was used to label apoptotic cells.	cells,61,66,Cell	"[{""token"": ""cells"", ""start_span"": 61, ""end_span"": 66, ""type"": ""Cell""}]"	valid
It is considered that resection of the primary tumor induces activation of systemic angiogenesis and enhances progression of remote metastasis.	tumor,47,52,Cancer	"[{""token"": ""tumor"", ""start_span"": 47, ""end_span"": 52, ""type"": ""Cancer""}]"	valid
Antiapoptotic effect of coagulation factor VIIa.	coagulation factor VIIa,24,47,Gene_or_gene_product	"[{""token"": ""coagulation factor VIIa"", ""start_span"": 24, ""end_span"": 47, ""type"": ""Gene_or_gene_product""}]"	valid
To understand the mechanisms behind these processes, we have examined the effect of FVIIa on apoptosis.	FVIIa,84,89,Gene_or_gene_product	"[{""token"": ""FVIIa"", ""start_span"": 84, ""end_span"": 89, ""type"": ""Gene_or_gene_product""}]"	valid
These accelerated relapses occur within 10 months of surgery for untreated patients.	patients,75,83,Organism	"[{""token"": ""patients"", ""start_span"": 75, ""end_span"": 83, ""type"": ""Organism""}]"	valid
The mechanism proposed is a stimulation of angiogenesis for distant dormant micrometastases.	distant dormant micrometastases,60,91,Cancer	"[{""token"": ""distant dormant micrometastases"", ""start_span"": 60, ""end_span"": 91, ""type"": ""Cancer""}]"	valid
This has been suggested as one of the mechanisms to explain the mammography paradox for women aged 40 - 49 years.	women,88,93,Organism	"[{""token"": ""women"", ""start_span"": 88, ""end_span"": 93, ""type"": ""Organism""}]"	valid
We could imagine that it also plays a role in adjuvant chemotherapy effectiveness since, perhaps not coincidentally, this is most beneficial for premenopausal node - positive patients.	patients,175,183,Organism	"[{""token"": ""patients"", ""start_span"": 175, ""end_span"": 183, ""type"": ""Organism""}]"	valid
We also speculate that this synchronizes them into a temporal highly chemosensitive state and is the underlying reason why adjuvant chemotherapy works particularly well for that patient category.	patient,178,185,Organism	"[{""token"": ""patient"", ""start_span"": 178, ""end_span"": 185, ""type"": ""Organism""}]"	valid
However, we need to determine whether it happens in breast cancer.	breast cancer,52,65,Cancer	"[{""token"": ""breast cancer"", ""start_span"": 52, ""end_span"": 65, ""type"": ""Cancer""}]"	valid
IMPLICATIONS: Short - course cytotoxic chemotherapy after surgery has probably reached its zenith, and other strategies, perhaps antiangiogenic methods, are needed to successfully treat more patients.	patients,191,199,Organism	"[{""token"": ""patients"", ""start_span"": 191, ""end_span"": 199, ""type"": ""Organism""}]"	valid
Therefore, the role of VEGF after seizures could be either protective or destructive.	VEGF,23,27,Gene_or_gene_product	"[{""token"": ""VEGF"", ""start_span"": 23, ""end_span"": 27, ""type"": ""Gene_or_gene_product""}]"	valid
Photodynamic therapy ( PDT) is a novel treatment entity that exploits the photophysical properties of various photosensitive chemical entities which, upon light activation, results in targeted photooxidation and subsequent tissue destruction.	tissue,223,229,Tissue	"[{""token"": ""tissue"", ""start_span"": 223, ""end_span"": 229, ""type"": ""Tissue""}]"	valid
The safety of verteporfin is directly dependent upon the appropriate integration of dosage, infusion and light activation required for a suitable pharmacotherapeutic outcome.	verteporfin,14,25,Chemical	"[{""token"": ""verteporfin"", ""start_span"": 14, ""end_span"": 25, ""type"": ""Chemical""}]"	valid
Presence of subfoveal CNV at 6 and 12 months of follow - up was determined by review of fluorescein angiograms.	fluorescein,88,99,Chemical	"[{""token"": ""fluorescein"", ""start_span"": 88, ""end_span"": 99, ""type"": ""Chemical""}]"	valid
Eleven lesions progressed to a subfoveal location by 12 months.	lesions,7,14,Pathological_formation	"[{""token"": ""lesions"", ""start_span"": 7, ""end_span"": 14, ""type"": ""Pathological_formation""}]"	valid
CONCLUSIONS: Despite a small sample size and limited length of follow - up, this study shows that visual acuity on average can remain stable for at least 12 months after PDT of juxtafoveal lesions.	juxtafoveal lesions,177,196,Pathological_formation	"[{""token"": ""juxtafoveal lesions"", ""start_span"": 177, ""end_span"": 196, ""type"": ""Pathological_formation""}]"	valid
Growth through the foveal center still can occur, however, and this can be associated with substantial visual loss.	foveal center,19,32,Tissue	"[{""token"": ""foveal center"", ""start_span"": 19, ""end_span"": 32, ""type"": ""Tissue""}]"	valid
However, no changes were observed in the presence of netrin - 1.	netrin - 1,53,63,Gene_or_gene_product	"[{""token"": ""netrin - 1"", ""start_span"": 53, ""end_span"": 63, ""type"": ""Gene_or_gene_product""}]"	valid
The rats were divided into 4 groups.	rats,4,8,Organism	"[{""token"": ""rats"", ""start_span"": 4, ""end_span"": 8, ""type"": ""Organism""}]"	valid
RESULTS: There was a statistically significant difference between the control and enoxaparine Na groups regarding adhesions.	enoxaparine Na,82,96,Chemical	"[{""token"": ""enoxaparine Na"", ""start_span"": 82, ""end_span"": 96, ""type"": ""Chemical""}]"	valid
Statistically significant differences were observed between groups 1 and 4 and between groups 1 and 3 regarding the hydroxyproline content of the abdominal wounds.	abdominal wounds,146,162,Pathological_formation	"[{""token"": ""abdominal wounds"", ""start_span"": 146, ""end_span"": 162, ""type"": ""Pathological_formation""}]"	valid
In the pathologic analysis of the abdominal wounds, there was no statistically significant difference between any of the groups, including the control group, regarding inflammation.	abdominal wounds,34,50,Pathological_formation	"[{""token"": ""abdominal wounds"", ""start_span"": 34, ""end_span"": 50, ""type"": ""Pathological_formation""}]"	valid
VEGF - targeted therapy: therapeutic potential and recent advances.	VEGF,0,4,Gene_or_gene_product	"[{""token"": ""VEGF"", ""start_span"": 0, ""end_span"": 4, ""type"": ""Gene_or_gene_product""}]"	valid
After over 30 years of theorizing, the use of angiogenesis inhibitors as anticancer therapy has finally moved from the realm of research to reality.	anticancer,73,83,Cancer	"[{""token"": ""anticancer"", ""start_span"": 73, ""end_span"": 83, ""type"": ""Cancer""}]"	valid
Cox proportional hazards multivariate analysis ( MVA) was used to determine the relation of MDM2 to the endpoints.	MDM2,92,96,Gene_or_gene_product	"[{""token"": ""MDM2"", ""start_span"": 92, ""end_span"": 96, ""type"": ""Gene_or_gene_product""}]"	valid
In the manual count analysis, there was no significant relation between MDM2 overexpression and outcome.	MDM2,72,76,Gene_or_gene_product	"[{""token"": ""MDM2"", ""start_span"": 72, ""end_span"": 76, ""type"": ""Gene_or_gene_product""}]"	valid
The intensity of MDM2 staining was not significant.	MDM2,17,21,Gene_or_gene_product	"[{""token"": ""MDM2"", ""start_span"": 17, ""end_span"": 21, ""type"": ""Gene_or_gene_product""}]"	valid
CONCLUSIONS: MDM2 expression quantified by image analysis was weakly associated with DM.	MDM2,13,17,Gene_or_gene_product	"[{""token"": ""MDM2"", ""start_span"": 13, ""end_span"": 17, ""type"": ""Gene_or_gene_product""}]"	valid
TSP interacts with a number of proteases and receptors and in this way inhibits stimulation of angiogenesis.	TSP,0,3,Gene_or_gene_product	"[{""token"": ""TSP"", ""start_span"": 0, ""end_span"": 3, ""type"": ""Gene_or_gene_product""}]"	valid
Simultaneously, MMP - 2 expression increases with malignancy.	MMP - 2,16,23,Gene_or_gene_product	"[{""token"": ""MMP - 2"", ""start_span"": 16, ""end_span"": 23, ""type"": ""Gene_or_gene_product""}]"	valid
Recent advances have fostered a more detailed understanding of molecular mechanisms and networks governing EMT in tumor progression.	tumor,114,119,Cancer	"[{""token"": ""tumor"", ""start_span"": 114, ""end_span"": 119, ""type"": ""Cancer""}]"	valid
Moreover, the downregulation of c - myc oncogene by an antisense strategy might represent a useful goal for improving the efficacy of this anti - neoplastic drug family.	c - myc,32,39,Gene_or_gene_product	"[{""token"": ""c - myc"", ""start_span"": 32, ""end_span"": 39, ""type"": ""Gene_or_gene_product""}]"	valid
At this time, the cells ' growth is arrested at very high density, and no differentiated morphologic characteristics are observed.	cells,18,23,Cell	"[{""token"": ""cells"", ""start_span"": 18, ""end_span"": 23, ""type"": ""Cell""}]"	valid
RESULTS: Thirty - two of 35 patients ( median age, 62 years) are evaluable for response.	patients,28,36,Organism	"[{""token"": ""patients"", ""start_span"": 28, ""end_span"": 36, ""type"": ""Organism""}]"	valid
"Trough celecoxib levels achieved targeted "" antiangiogenic "" levels."	celecoxib,7,16,Chemical	"[{""token"": ""celecoxib"", ""start_span"": 7, ""end_span"": 16, ""type"": ""Chemical""}]"	valid
Patients were followed up at 1 month and 3 months after treatment and thereafter at 3 - month intervals.	Patients,0,8,Organism	"[{""token"": ""Patients"", ""start_span"": 0, ""end_span"": 8, ""type"": ""Organism""}]"	valid
CONCLUSION: PDT preserves vision in patients with CNV associated with PM.	patients,36,44,Organism	"[{""token"": ""patients"", ""start_span"": 36, ""end_span"": 44, ""type"": ""Organism""}]"	valid
Carcinogenesis and transcriptional regulation through Maf recognition elements.	Maf,54,57,Gene_or_gene_product	"[{""token"": ""Maf"", ""start_span"": 54, ""end_span"": 57, ""type"": ""Gene_or_gene_product""}]"	valid
Many studies on carcinogenesis carried out early in the last century are united on the consensus that cancer is a genetic disease.	cancer,102,108,Cancer	"[{""token"": ""cancer"", ""start_span"": 102, ""end_span"": 108, ""type"": ""Cancer""}]"	valid
Cancer cells typically display gene dysfunction and endogenous or exogenous insults resulting in gene dysfunction are often carcinogenic.	Cancer cells,0,12,Cell	"[{""token"": ""Cancer cells"", ""start_span"": 0, ""end_span"": 12, ""type"": ""Cell""}]"	valid
Adaptive landscapes and emergent phenotypes: why do cancers have high glycolysis?	cancers,52,59,Cancer	"[{""token"": ""cancers"", ""start_span"": 52, ""end_span"": 59, ""type"": ""Cancer""}]"	valid
Investigating the causes of increased aerobic glycolysis in tumors ( Warburg Effect) has gone in and out of fashion many times since it was first described almost a century ago.	tumors,60,66,Cancer	"[{""token"": ""tumors"", ""start_span"": 60, ""end_span"": 66, ""type"": ""Cancer""}]"	valid
There is also an implicit assumption that a mechanistic understanding, although fundamentally reductionist, will nonetheless lead to a more profound teleological understanding of the need for altered metabolism in invasive cancers.	cancers,223,230,Cancer	"[{""token"": ""cancers"", ""start_span"": 223, ""end_span"": 230, ""type"": ""Cancer""}]"	valid
In this communication, we describe an alternative approach that begins with teleology; i. e. adaptive landscapes and selection pressures that promote emergence of aerobic glycolysis during the somatic evolution of invasive cancer.	cancer,223,229,Cancer	"[{""token"": ""cancer"", ""start_span"": 223, ""end_span"": 229, ""type"": ""Cancer""}]"	valid
PURPOSE: Spironolactone has recently been shown to have suppressive effects on several immunoactive and proinflammatory cytokines.	Spironolactone,9,23,Chemical	"[{""token"": ""Spironolactone"", ""start_span"": 9, ""end_span"": 23, ""type"": ""Chemical""}]"	valid
CONCLUSION: We present initial results demonstrating anti - inflammatory effects of spironolactone.	spironolactone,84,98,Chemical	"[{""token"": ""spironolactone"", ""start_span"": 84, ""end_span"": 98, ""type"": ""Chemical""}]"	valid
Recent evidence suggests an association of these polymorphisms with an increased risk of cervical cancer, so we explored this relationship.	cervical cancer,89,104,Cancer	"[{""token"": ""cervical cancer"", ""start_span"": 89, ""end_span"": 104, ""type"": ""Cancer""}]"	valid
Associations with cancer risk were estimated using two - sided logistic regression.	cancer,18,24,Cancer	"[{""token"": ""cancer"", ""start_span"": 18, ""end_span"": 24, ""type"": ""Cancer""}]"	valid
None of the polymorphisms were associated with risk of advanced stage or histologic subtype of cervical cancer.	cervical cancer,95,110,Cancer	"[{""token"": ""cervical cancer"", ""start_span"": 95, ""end_span"": 110, ""type"": ""Cancer""}]"	valid
LVI is associated with axillary lymph node metastases ( ALNM) and a long - term prognostic factor.	axillary lymph node,23,42,Multi	"[{""token"": ""axillary lymph node"", ""start_span"": 23, ""end_span"": 42, ""type"": ""Multi""}]"	valid
There was a significant correlation between D2 - 40 + LVI and age, t - stage, nodal status, grading and hormonreceptor - status.	D2 - 40,44,51,Gene_or_gene_product	"[{""token"": ""D2 - 40"", ""start_span"": 44, ""end_span"": 51, ""type"": ""Gene_or_gene_product""}]"	valid
In a multivariate analysis D2 - 40 + was the strongest predictor for ALNM with an odds ratio of 3. 489 and a P - value of P = 0. 0003, followed only by T - stage and grading with odds ratios of 3. 167 and 1. 953 and P - values P = 0. 0003 and P = 0. 0352.	D2 - 40,27,34,Gene_or_gene_product	"[{""token"": ""D2 - 40"", ""start_span"": 27, ""end_span"": 34, ""type"": ""Gene_or_gene_product""}]"	valid
Further prospective studies are needed to prove the clinical impact of D2 - 40.	D2 - 40,71,78,Gene_or_gene_product	"[{""token"": ""D2 - 40"", ""start_span"": 71, ""end_span"": 78, ""type"": ""Gene_or_gene_product""}]"	valid
Solid tumors express a range of factors required to sustain their growth and promote their dissemination.	Solid tumors,0,12,Cancer	"[{""token"": ""Solid tumors"", ""start_span"": 0, ""end_span"": 12, ""type"": ""Cancer""}]"	valid
METHODS: Standard therapy with primary resection followed by adjuvant chemotherapy and radiation had failed in all patients.	patients,115,123,Organism	"[{""token"": ""patients"", ""start_span"": 115, ""end_span"": 123, ""type"": ""Organism""}]"	valid
RESULTS: Of the 13 treated patients, 10 ( 77%) had a radiologically demonstrated partial response and 3 ( 23%) had stable disease.	patients,27,35,Organism	"[{""token"": ""patients"", ""start_span"": 27, ""end_span"": 35, ""type"": ""Organism""}]"	valid
Six patients ( 46%) had a clinical response.	patients,4,12,Organism	"[{""token"": ""patients"", ""start_span"": 4, ""end_span"": 12, ""type"": ""Organism""}]"	valid
The disease progressed in 8 patients, despite an initial response.	patients,28,36,Organism	"[{""token"": ""patients"", ""start_span"": 28, ""end_span"": 36, ""type"": ""Organism""}]"	valid
Five patients are still responding to therapy.	patients,5,13,Organism	"[{""token"": ""patients"", ""start_span"": 5, ""end_span"": 13, ""type"": ""Organism""}]"	valid
Six of the 8 patients whose disease progressed have died.	patients,13,21,Organism	"[{""token"": ""patients"", ""start_span"": 13, ""end_span"": 21, ""type"": ""Organism""}]"	valid
Tumor growth was determined and survival was recorded.	Tumor,0,5,Cancer	"[{""token"": ""Tumor"", ""start_span"": 0, ""end_span"": 5, ""type"": ""Cancer""}]"	valid
TUNEL assay and microvessel density was assessed to evaluate apoptosis and angiogenesis.	microvessel,16,27,Tissue	"[{""token"": ""microvessel"", ""start_span"": 16, ""end_span"": 27, ""type"": ""Tissue""}]"	valid
These results show that STX243 is a potent in vivo drug and could be clinically effective at treating a number of oncological conditions.	STX243,24,30,Chemical	"[{""token"": ""STX243"", ""start_span"": 24, ""end_span"": 30, ""type"": ""Chemical""}]"	valid
Blockade of angiogenesis is an important approach for cancer treatment and prevention.	cancer,54,60,Cancer	"[{""token"": ""cancer"", ""start_span"": 54, ""end_span"": 60, ""type"": ""Cancer""}]"	valid
However, most current anti - VEGF agents often cause some side effects when given chronically.	VEGF,29,33,Gene_or_gene_product	"[{""token"": ""VEGF"", ""start_span"": 29, ""end_span"": 33, ""type"": ""Gene_or_gene_product""}]"	valid
Identification of naturally occurring VEGF inhibitors derived from diet would be one alternative approach with an advantage of known safety.	VEGF,38,42,Gene_or_gene_product	"[{""token"": ""VEGF"", ""start_span"": 38, ""end_span"": 42, ""type"": ""Gene_or_gene_product""}]"	valid
A similar trend was noted in the SCCVII tumor model.	SCCVII tumor,33,45,Cancer	"[{""token"": ""SCCVII tumor"", ""start_span"": 33, ""end_span"": 45, ""type"": ""Cancer""}]"	valid
In the present study, we found significant binding of nicked beta2GPI to AS4. 5 ( K ( D) = 3. 27 x 10 ( 6) M ( - 1)).	nicked beta2GPI,54,69,Gene_or_gene_product	"[{""token"": ""nicked beta2GPI"", ""start_span"": 54, ""end_span"": 69, ""type"": ""Gene_or_gene_product""}]"	valid
In contrast, intact beta2GPI does not bind to AS4. 5 or inhibit its antiangiogenic activity.	beta2GPI,20,28,Gene_or_gene_product	"[{""token"": ""beta2GPI"", ""start_span"": 20, ""end_span"": 28, ""type"": ""Gene_or_gene_product""}]"	valid
METHODS: Thirty - six New Zealand white rabbits were evaluated in this study.	New Zealand white rabbits,22,47,Organism	"[{""token"": ""New Zealand white rabbits"", ""start_span"": 22, ""end_span"": 47, ""type"": ""Organism""}]"	valid
In control group, there was no vascular bundle implantation.	vascular bundle,31,46,Multi	"[{""token"": ""vascular bundle"", ""start_span"": 31, ""end_span"": 46, ""type"": ""Multi""}]"	valid
RESULTS: The bone grafts were found revascularization in 3 days after surgery in the test group, whereas at 2 weeks in the control group.	bone grafts,13,24,Multi	"[{""token"": ""bone grafts"", ""start_span"": 13, ""end_span"": 24, ""type"": ""Multi""}]"	valid
Myeloma cells counteracted the metabolic stress by activating autophagy.	Myeloma cells,0,13,Cell	"[{""token"": ""Myeloma cells"", ""start_span"": 0, ""end_span"": 13, ""type"": ""Cell""}]"	valid
Co - treatment with inhibitors of autophagy results in marked enhancement of cell death.	cell,77,81,Cell	"[{""token"": ""cell"", ""start_span"": 77, ""end_span"": 81, ""type"": ""Cell""}]"	valid
This study establishes the potential of metabolic targeting as a broader means to kill and sensitize myeloma and identifies a compound that can achieve this goal.	myeloma,101,108,Cancer	"[{""token"": ""myeloma"", ""start_span"": 101, ""end_span"": 108, ""type"": ""Cancer""}]"	valid
METHODS: Thirty - two male wistar rats randomly divided into four groups.	wistar rats,27,38,Organism	"[{""token"": ""wistar rats"", ""start_span"": 27, ""end_span"": 38, ""type"": ""Organism""}]"	valid
Targeted antibody - based therapy has been used successfully to treat cancers.	cancers,70,77,Cancer	"[{""token"": ""cancers"", ""start_span"": 70, ""end_span"": 77, ""type"": ""Cancer""}]"	valid
Angiogenesis has become an attractive target for drug therapy because of its key role in tumor growth.	tumor,89,94,Cancer	"[{""token"": ""tumor"", ""start_span"": 89, ""end_span"": 94, ""type"": ""Cancer""}]"	valid
The following review describes key molecular mechanisms and novel therapies that are on the horizon for antiangiogenic tumor therapy.	tumor,119,124,Cancer	"[{""token"": ""tumor"", ""start_span"": 119, ""end_span"": 124, ""type"": ""Cancer""}]"	valid
These results strongly suggested that the BI - 1 gene might play a crucial role in neoplastic genesis and development.	BI - 1,42,48,Gene_or_gene_product	"[{""token"": ""BI - 1"", ""start_span"": 42, ""end_span"": 48, ""type"": ""Gene_or_gene_product""}]"	valid
The long latency of prostate cancer development provides an opportunity to intervene with agents of known mechanisms at various stages of disease progression.	prostate cancer,20,35,Cancer	"[{""token"": ""prostate cancer"", ""start_span"": 20, ""end_span"": 35, ""type"": ""Cancer""}]"	valid
Crosstalk between these two pathways is also thought to contribute to progression and hormone - refractory prostate disease.	prostate disease,107,123,Cancer	"[{""token"": ""prostate disease"", ""start_span"": 107, ""end_span"": 123, ""type"": ""Cancer""}]"	valid
Inhibitors of Hedgehog signaling have been the subject of intense research.	Hedgehog,14,22,Gene_or_gene_product	"[{""token"": ""Hedgehog"", ""start_span"": 14, ""end_span"": 22, ""type"": ""Gene_or_gene_product""}]"	valid
Analysis of promoter hypermethylation of the APC gene was also carried out using methylation - specific PCR ( MS - PCR).	APC,45,48,Gene_or_gene_product	"[{""token"": ""APC"", ""start_span"": 45, ""end_span"": 48, ""type"": ""Gene_or_gene_product""}]"	valid
Promoter hypermethylation of APC was observed in 54. 65 per cent ( 47 of 86) of cases.	APC,29,32,Gene_or_gene_product	"[{""token"": ""APC"", ""start_span"": 29, ""end_span"": 32, ""type"": ""Gene_or_gene_product""}]"	valid
It has been reported that rhizocalin and its derivates have a chemopreventive and chemotherapeutic effect.	rhizocalin,26,36,Chemical	"[{""token"": ""rhizocalin"", ""start_span"": 26, ""end_span"": 36, ""type"": ""Chemical""}]"	valid
Molecular modeling studies suggested that mutation N172D, located within the substrate binding region, is mainly responsible for impaired mutCK1delta activity.	mutCK1delta,138,149,Gene_or_gene_product	"[{""token"": ""mutCK1delta"", ""start_span"": 138, ""end_span"": 149, ""type"": ""Gene_or_gene_product""}]"	valid
Two of them were selected for high or low osteonectin expression and tested in vivo in spontaneous and artificial metastasis assays.	osteonectin,42,53,Gene_or_gene_product	"[{""token"": ""osteonectin"", ""start_span"": 42, ""end_span"": 53, ""type"": ""Gene_or_gene_product""}]"	valid
Pathologic conditions included dystrophia, moderate dysplasia, severe dysplasia, and intraepithelial carcinoma.	intraepithelial carcinoma,85,110,Cancer	"[{""token"": ""intraepithelial carcinoma"", ""start_span"": 85, ""end_span"": 110, ""type"": ""Cancer""}]"	valid
Glycolysis and glutaminolysis in perifused Ehrlich ascites tumour cells.	Ehrlich ascites tumour cells,43,71,Cell	"[{""token"": ""Ehrlich ascites tumour cells"", ""start_span"": 43, ""end_span"": 71, ""type"": ""Cell""}]"	valid
These activities provide an explanation for the angiogenic properties of EGF in vivo.	EGF,73,76,Gene_or_gene_product	"[{""token"": ""EGF"", ""start_span"": 73, ""end_span"": 76, ""type"": ""Gene_or_gene_product""}]"	valid
While the study of angiogenesis as a phenomenon is still in an early phase, it has become possible, by using a combination of in vitro and in vivo techniques, to more thoroughly understand the initiation and control of capillary growth.	capillary,219,228,Tissue	"[{""token"": ""capillary"", ""start_span"": 219, ""end_span"": 228, ""type"": ""Tissue""}]"	valid
At intervals of four to 14 days, the animals were challenged by intrastromal inoculation with 10, 000 plaque - forming units of viable HSV.	HSV,135,138,Organism	"[{""token"": ""HSV"", ""start_span"": 135, ""end_span"": 138, ""type"": ""Organism""}]"	valid
The absence of iritis, neovascularization, and necrotizing keratitis in the corneas of the immunized animals was particularly striking.	corneas,76,83,Multi	"[{""token"": ""corneas"", ""start_span"": 76, ""end_span"": 83, ""type"": ""Multi""}]"	valid
Under specific conditions, casein could be used as an exogenous substrate as well.	casein,27,33,Gene_or_gene_product	"[{""token"": ""casein"", ""start_span"": 27, ""end_span"": 33, ""type"": ""Gene_or_gene_product""}]"	valid
Although contaminating kinases were detectable in the immune complexes, at least the p53 molecules were phosphorylated in vitro in a more specific way.	p53,85,88,Gene_or_gene_product	"[{""token"": ""p53"", ""start_span"": 85, ""end_span"": 88, ""type"": ""Gene_or_gene_product""}]"	valid
It was shown that large T - antigen showed associated kinase activity, although none of our results could unambiguously demonstrate an intrinsic kinase activity of this protein.	large T - antigen,18,35,Gene_or_gene_product	"[{""token"": ""large T - antigen"", ""start_span"": 18, ""end_span"": 35, ""type"": ""Gene_or_gene_product""}]"	valid
Thus, it is highly unlikely that the p53 molecule per se carries intrinsic or even associated kinase activities.	p53,37,40,Gene_or_gene_product	"[{""token"": ""p53"", ""start_span"": 37, ""end_span"": 40, ""type"": ""Gene_or_gene_product""}]"	valid
Molecular mediators of interactions with extracellular matrix components in metastasis and angiogenesis.	extracellular matrix components,41,72,Cellular_component	"[{""token"": ""extracellular matrix components"", ""start_span"": 41, ""end_span"": 72, ""type"": ""Cellular_component""}]"	valid
Metastasis and tumor angiogenesis are invasive phenomena and share many common properties at the physiological level and some similarities at the molecular level.	tumor,15,20,Cancer	"[{""token"": ""tumor"", ""start_span"": 15, ""end_span"": 20, ""type"": ""Cancer""}]"	valid
Some potentially promising prognostic, diagnostic, and therapeutic modalities for tumor angiogenesis and metastatic disease are also discussed.	tumor,82,87,Cancer	"[{""token"": ""tumor"", ""start_span"": 82, ""end_span"": 87, ""type"": ""Cancer""}]"	valid
These transcripts were localized in stromal fibroblasts adjacent to the neoplastic foci.	stromal fibroblasts,36,55,Cell	"[{""token"": ""stromal fibroblasts"", ""start_span"": 36, ""end_span"": 55, ""type"": ""Cell""}]"	valid
This protein is produced in large amounts by fibroblasts cultivated in vitro.	fibroblasts,45,56,Cell	"[{""token"": ""fibroblasts"", ""start_span"": 45, ""end_span"": 56, ""type"": ""Cell""}]"	valid
Since all these cells lack any mRNA for collagen, XII, it seems likely that the synthesis is blocked at the transcriptional level.	cells,16,21,Cell	"[{""token"": ""cells"", ""start_span"": 16, ""end_span"": 21, ""type"": ""Cell""}]"	valid
Experiments with a temperature - sensitive mutant of Rous sarcoma virus demonstrated that a single oncogene product is sufficient to inhibit the synthesis.	Rous sarcoma virus,53,71,Organism	"[{""token"": ""Rous sarcoma virus"", ""start_span"": 53, ""end_span"": 71, ""type"": ""Organism""}]"	valid
[ 13C] Lactate production from [ 13C] glucose, with no detectable uptake of [ 13C] alanine, indicated that energy production in H5 spheroids was primarily via glycolysis.	H5 spheroids,128,140,Cell	"[{""token"": ""H5 spheroids"", ""start_span"": 128, ""end_span"": 140, ""type"": ""Cell""}]"	valid
These proteins are mainly produced by specific integral parts of the viral genome, the oncogenes.	viral,69,74,Organism	"[{""token"": ""viral"", ""start_span"": 69, ""end_span"": 74, ""type"": ""Organism""}]"	valid
They are important components of the growth regulatory pathways in normal cells.	cells,74,79,Cell	"[{""token"": ""cells"", ""start_span"": 74, ""end_span"": 79, ""type"": ""Cell""}]"	valid
The induction of elevated p53 levels was dependent upon the presence of active virus and was prevented by neutralizing antibody.	p53,26,29,Gene_or_gene_product	"[{""token"": ""p53"", ""start_span"": 26, ""end_span"": 29, ""type"": ""Gene_or_gene_product""}]"	valid
This observed genomic instability will be of value in predicting the potential metastatic behavior of these aggressive pituitary tumors.	pituitary tumors,119,135,Cancer	"[{""token"": ""pituitary tumors"", ""start_span"": 119, ""end_span"": 135, ""type"": ""Cancer""}]"	valid
Its suppression has also been shown to be associated with malignant transformation of epithelial cells.	epithelial cells,86,102,Cell	"[{""token"": ""epithelial cells"", ""start_span"": 86, ""end_span"": 102, ""type"": ""Cell""}]"	valid
[ Effects of carcinostatic agents in the hematogenous metastasis of cancer].	cancer,68,74,Cancer	"[{""token"": ""cancer"", ""start_span"": 68, ""end_span"": 74, ""type"": ""Cancer""}]"	valid
Potential roles for focal adhesion kinase in development.	focal adhesion kinase,20,41,Gene_or_gene_product	"[{""token"": ""focal adhesion kinase"", ""start_span"": 20, ""end_span"": 41, ""type"": ""Gene_or_gene_product""}]"	valid
In this review, this evidence is surveyed together with evidence from analogous situations, such as tumour cell migration and invasiveness.	tumour cell,100,111,Cell	"[{""token"": ""tumour cell"", ""start_span"": 100, ""end_span"": 111, ""type"": ""Cell""}]"	valid
Positron emission tomography in a case of intracranial hemangiopericytoma.	intracranial hemangiopericytoma,42,73,Cancer	"[{""token"": ""intracranial hemangiopericytoma"", ""start_span"": 42, ""end_span"": 73, ""type"": ""Cancer""}]"	test
At present, the percentage of such a modification is low, unless referred to selected series of tumours.	tumours,96,103,Cancer	"[{""token"": ""tumours"", ""start_span"": 96, ""end_span"": 103, ""type"": ""Cancer""}]"	test
p53 protein staining was positive in 29. 7%.	p53,0,3,Gene_or_gene_product	"[{""token"": ""p53"", ""start_span"": 0, ""end_span"": 3, ""type"": ""Gene_or_gene_product""}]"	test
WT1 represses transcription of several growth factors and growth factor receptors.	WT1,0,3,Gene_or_gene_product	"[{""token"": ""WT1"", ""start_span"": 0, ""end_span"": 3, ""type"": ""Gene_or_gene_product""}]"	test
In conclusion, the present study clearly demonstrates the potential of vector - mediated antiangiogenic gene therapy as a component in cancer therapy.	cancer,135,141,Cancer	"[{""token"": ""cancer"", ""start_span"": 135, ""end_span"": 141, ""type"": ""Cancer""}]"	test
Genetic alterations at final sigma such as loss of heterozygosity were rare ( 1 / 20 informative cases), and no mutations were detected ( 0 / 34).	final sigma,23,34,Gene_or_gene_product	"[{""token"": ""final sigma"", ""start_span"": 23, ""end_span"": 34, ""type"": ""Gene_or_gene_product""}]"	test
Eight founder and progeny mice of 5 different lines were monitored for leukemogenesis.	mice,26,30,Organism	"[{""token"": ""mice"", ""start_span"": 26, ""end_span"": 30, ""type"": ""Organism""}]"	test
Building the vertebrate vasculature: research is going swimmingly.	vasculature,24,35,Anatomical_system	"[{""token"": ""vasculature"", ""start_span"": 24, ""end_span"": 35, ""type"": ""Anatomical_system""}]"	test
The vertebrate vasculature develops in remarkably similar fashion in all vertebrates.	vasculature,15,26,Anatomical_system	"[{""token"": ""vasculature"", ""start_span"": 15, ""end_span"": 26, ""type"": ""Anatomical_system""}]"	test
This primitive vascular network is extensively remodeled in some places, and expanded by sprouting in others.	vascular network,15,31,Anatomical_system	"[{""token"": ""vascular network"", ""start_span"": 15, ""end_span"": 31, ""type"": ""Anatomical_system""}]"	test
A summary is made of recent advances in the understanding of IL - 18 structure, processing, receptor expression and immunoregulatory functions.	IL - 18,61,68,Gene_or_gene_product	"[{""token"": ""IL - 18"", ""start_span"": 61, ""end_span"": 68, ""type"": ""Gene_or_gene_product""}]"	test
The nm23 gene is a conspicuous metastasis - suppressor gene.	nm23,4,8,Gene_or_gene_product	"[{""token"": ""nm23"", ""start_span"": 4, ""end_span"": 8, ""type"": ""Gene_or_gene_product""}]"	test
These results suggest that overexpression of PLD isozymes may play an important role in neoplastic transformation.	PLD,45,48,Gene_or_gene_product	"[{""token"": ""PLD"", ""start_span"": 45, ""end_span"": 48, ""type"": ""Gene_or_gene_product""}]"	test
Despite convincing evidence of its efficacy, little is known about the mechanism of action of TnI as an anti - proliferative and anti - angiogenic agent.	TnI,94,97,Gene_or_gene_product	"[{""token"": ""TnI"", ""start_span"": 94, ""end_span"": 97, ""type"": ""Gene_or_gene_product""}]"	test
As antagonists were used the tripeptide FPR and non - peptide 1, 4 - disubstituted piperazine derivatives.	tripeptide FPR,29,43,Gene_or_gene_product	"[{""token"": ""tripeptide FPR"", ""start_span"": 29, ""end_span"": 43, ""type"": ""Gene_or_gene_product""}]"	test
These results suggest that non - thrombogenic agonists or antagonists of the activated thrombin receptor can be used as modulators of angiogenesis.	thrombin receptor,87,104,Gene_or_gene_product	"[{""token"": ""thrombin receptor"", ""start_span"": 87, ""end_span"": 104, ""type"": ""Gene_or_gene_product""}]"	test
Increasing evidence suggests that elevated expression of ErbB - 3 is important for malignancy.	ErbB - 3,57,65,Gene_or_gene_product	"[{""token"": ""ErbB - 3"", ""start_span"": 57, ""end_span"": 65, ""type"": ""Gene_or_gene_product""}]"	test
Interference with the function of transcription factor AP - 2 might provide a potential strategy for modulation of the malignant phenotype.	AP - 2,55,61,Gene_or_gene_product	"[{""token"": ""AP - 2"", ""start_span"": 55, ""end_span"": 61, ""type"": ""Gene_or_gene_product""}]"	test
[ Radiologic - pathologic correlations in breast diseases]	breast,42,48,Organism_subdivision	"[{""token"": ""breast"", ""start_span"": 42, ""end_span"": 48, ""type"": ""Organism_subdivision""}]"	test
A 71 - year - old woman was admitted to our hospital because of breathlessness.	woman,18,23,Organism	"[{""token"": ""woman"", ""start_span"": 18, ""end_span"": 23, ""type"": ""Organism""}]"	test
One hundred mg / body / day of TS - 1 was orally administrated for 4 weeks.	TS - 1,31,37,Chemical	"[{""token"": ""TS - 1"", ""start_span"": 31, ""end_span"": 37, ""type"": ""Chemical""}]"	test
A partial response ( PR) was obtained after the first course with regression of multiple pulmonary metastases.	pulmonary,89,98,Organ	"[{""token"": ""pulmonary"", ""start_span"": 89, ""end_span"": 98, ""type"": ""Organ""}]"	test
After 1 drug - free week, the second course was administered with 120 mg / body / day of TS - 1 for 4 weeks.	TS - 1,89,95,Chemical	"[{""token"": ""TS - 1"", ""start_span"": 89, ""end_span"": 95, ""type"": ""Chemical""}]"	test
The archival surgical pathology files of The Johns Hopkins Hospital were searched for cases of brain metastases biopsied between 1990 and 2000.	brain,95,100,Organ	"[{""token"": ""brain"", ""start_span"": 95, ""end_span"": 100, ""type"": ""Organ""}]"	test
The medical records were reviewed independent of the staining results to determine site of tumor origin.	tumor,91,96,Cancer	"[{""token"": ""tumor"", ""start_span"": 91, ""end_span"": 96, ""type"": ""Cancer""}]"	test
Ultimately, the primary site was established on clinical and radiographic grounds in 71 cases ( 95%).	site,24,28,Multi	"[{""token"": ""site"", ""start_span"": 24, ""end_span"": 28, ""type"": ""Multi""}]"	test
In a first step, proteins were selected which showed a relationship to lymph node involvement.	lymph node,71,81,Multi	"[{""token"": ""lymph node"", ""start_span"": 71, ""end_span"": 81, ""type"": ""Multi""}]"	test
317615 x 2HCl is a promising new antiangiogenic agent that is in early phase clinical testing.	317615 x 2HCl,0,13,Chemical	"[{""token"": ""317615 x 2HCl"", ""start_span"": 0, ""end_span"": 13, ""type"": ""Chemical""}]"	test
After 2 h incubation at 37 degrees C the drop in the ATP level was much lower.	ATP,53,56,Chemical	"[{""token"": ""ATP"", ""start_span"": 53, ""end_span"": 56, ""type"": ""Chemical""}]"	test
Aberrant angiogenesis is often associated with lesion formation in chronic periodontitis.	lesion,47,53,Pathological_formation	"[{""token"": ""lesion"", ""start_span"": 47, ""end_span"": 53, ""type"": ""Pathological_formation""}]"	test
This was markedly suppressed upon simultaneous injection of anti - VEGF polyclonal antibodies with the supernatant.	VEGF,67,71,Gene_or_gene_product	"[{""token"": ""VEGF"", ""start_span"": 67, ""end_span"": 71, ""type"": ""Gene_or_gene_product""}]"	test
In the face fo the fatal outcome, new approaches to the therapy have been established.	fatal,19,24,Developing_anatomical_structure	"[{""token"": ""fatal"", ""start_span"": 19, ""end_span"": 24, ""type"": ""Developing_anatomical_structure""}]"	test
RESULTS: The control group showed the highest level of corneal clouding and neovascularization.	corneal,55,62,Multi	"[{""token"": ""corneal"", ""start_span"": 55, ""end_span"": 62, ""type"": ""Multi""}]"	test
After additional prednisolone treatment from day 9 or 15 after inoculation, no significant difference was detected in the recultivation rate of C. albicans compared with the control.	prednisolone,17,29,Chemical	"[{""token"": ""prednisolone"", ""start_span"": 17, ""end_span"": 29, ""type"": ""Chemical""}]"	test
Early administration of prednisolone ( day 3, low and high dose) resulted in the recultivation of significantly more C. albicans.	prednisolone,24,36,Chemical	"[{""token"": ""prednisolone"", ""start_span"": 24, ""end_span"": 36, ""type"": ""Chemical""}]"	test
Whereas agents seem promising in the test tube, clinical trials often fail due to unfavorable pharmacokinetics, poor delivery, low local concentrations, and limited accumulation in the target cell.	cell,192,196,Cell	"[{""token"": ""cell"", ""start_span"": 192, ""end_span"": 196, ""type"": ""Cell""}]"	test
Eight randomly assigned 4 x 4 - cm2 pieces of two different meshes were fixed in the preperitoneal space with a centrally placed single suture.	preperitoneal space,85,104,Immaterial_anatomical_entity	"[{""token"": ""preperitoneal space"", ""start_span"": 85, ""end_span"": 104, ""type"": ""Immaterial_anatomical_entity""}]"	test
These angiogenic activities are neutralized by a specific antibody against CCL16.	CCL16,75,80,Gene_or_gene_product	"[{""token"": ""CCL16"", ""start_span"": 75, ""end_span"": 80, ""type"": ""Gene_or_gene_product""}]"	test
Loss - of - function effects were also observed in HIF - 1alpha - null embryonic stem cells.	HIF - 1alpha,51,63,Gene_or_gene_product	"[{""token"": ""HIF - 1alpha"", ""start_span"": 51, ""end_span"": 63, ""type"": ""Gene_or_gene_product""}]"	test
In all cases, there was complete concordance between the effects of hypoxia and AdCA5.	AdCA5,80,85,Organism	"[{""token"": ""AdCA5"", ""start_span"": 80, ""end_span"": 85, ""type"": ""Organism""}]"	test
Differential regulation of in vivo angiogenesis by angiotensin II receptors.	angiotensin II receptors,51,75,Gene_or_gene_product	"[{""token"": ""angiotensin II receptors"", ""start_span"": 51, ""end_span"": 75, ""type"": ""Gene_or_gene_product""}]"	test
Statistical analysis was performed to explore the links between expression of the CCN genes and clinical and pathological parameters.	CCN,82,85,Gene_or_gene_product	"[{""token"": ""CCN"", ""start_span"": 82, ""end_span"": 85, ""type"": ""Gene_or_gene_product""}]"	test
Normal cells are 10 - to 50 - fold more resistant to these effects.	Normal cells,0,12,Cell	"[{""token"": ""Normal cells"", ""start_span"": 0, ""end_span"": 12, ""type"": ""Cell""}]"	test
The results imply that various different proteins may lead to HCC metastasis together.	HCC,62,65,Cancer	"[{""token"": ""HCC"", ""start_span"": 62, ""end_span"": 65, ""type"": ""Cancer""}]"	test
These aspects of OPN biology are important in tumorigenesis.	OPN,17,20,Gene_or_gene_product	"[{""token"": ""OPN"", ""start_span"": 17, ""end_span"": 20, ""type"": ""Gene_or_gene_product""}]"	test
Oxygen metabolism has an important role in the pathogenesis of rheumatoid arthritis.	Oxygen,0,6,Chemical	"[{""token"": ""Oxygen"", ""start_span"": 0, ""end_span"": 6, ""type"": ""Chemical""}]"	test
To explore the gene expression changes that occur downstream of ELK - 1 dephosphorylation, we used a combination of temporal gene expression data and promoter element analyses.	ELK - 1,64,71,Gene_or_gene_product	"[{""token"": ""ELK - 1"", ""start_span"": 64, ""end_span"": 71, ""type"": ""Gene_or_gene_product""}]"	test
Intrauterine growth restriction ( IUGR) still accounts for a large incidence of infant mortality and morbidity worldwide.	infant,80,86,Organism	"[{""token"": ""infant"", ""start_span"": 80, ""end_span"": 86, ""type"": ""Organism""}]"	test
The effects of these alterations in placental functional development appear to be irreversible.	placental,36,45,Organ	"[{""token"": ""placental"", ""start_span"": 36, ""end_span"": 45, ""type"": ""Organ""}]"	test
It is therefore highly likely that these alterations are an important component in tumor resistance to therapy.	tumor,83,88,Cancer	"[{""token"": ""tumor"", ""start_span"": 83, ""end_span"": 88, ""type"": ""Cancer""}]"	test
Coronary collateral circulation ( CCC) was analyzed according to the Rentrop system.	Coronary collateral,0,19,Multi	"[{""token"": ""Coronary collateral"", ""start_span"": 0, ""end_span"": 19, ""type"": ""Multi""}]"	test
When the two groups were compared with respect to poor and good CCC, poor CCC was higher in patients with PDR ( 64 vs. 36%, respectively, p = 0. 01).	patients,92,100,Organism	"[{""token"": ""patients"", ""start_span"": 92, ""end_span"": 100, ""type"": ""Organism""}]"	test
VEGFR1 - positive haematopoietic bone marrow progenitors initiate the pre - metastatic niche.	VEGFR1,0,6,Gene_or_gene_product	"[{""token"": ""VEGFR1"", ""start_span"": 0, ""end_span"": 6, ""type"": ""Gene_or_gene_product""}]"	test
The efficacy of the approach may be critically dependent on the intrinsic susceptibility to apoptosis of different tumors.	tumors,115,121,Cancer	"[{""token"": ""tumors"", ""start_span"": 115, ""end_span"": 121, ""type"": ""Cancer""}]"	test
Suppression of PIM - 1 activity had a negligible effect on transformation.	PIM - 1,15,22,Gene_or_gene_product	"[{""token"": ""PIM - 1"", ""start_span"": 15, ""end_span"": 22, ""type"": ""Gene_or_gene_product""}]"	test
Targeting the PIM kinase family could provide a new avenue to overcome resistance against small - molecule tyrosine kinase inhibitors.	tyrosine,107,115,Amino_acid	"[{""token"": ""tyrosine"", ""start_span"": 107, ""end_span"": 115, ""type"": ""Amino_acid""}]"	test
In order to explore the mechanism of action of angiostatin and its mimetics, further work needs to be done to evaluate clinical applicability, specificity, and contraindications for this class of therapeutics.	angiostatin,47,58,Gene_or_gene_product	"[{""token"": ""angiostatin"", ""start_span"": 47, ""end_span"": 58, ""type"": ""Gene_or_gene_product""}]"	test
MATERIALS AND METHODS: Porous PLGA microspheres having primary amine groups on the surface were prepared using an oil - in - water ( O / W) single emulsion method using Pluronic F - 127 as an extractable porogen.	PLGA,30,34,Chemical	"[{""token"": ""PLGA"", ""start_span"": 30, ""end_span"": 34, ""type"": ""Chemical""}]"	test
Heparin was surface immobilized via covalent conjugation.	Heparin,0,7,Chemical	"[{""token"": ""Heparin"", ""start_span"": 0, ""end_span"": 7, ""type"": ""Chemical""}]"	test
RESULTS: PLGA microspheres with an open - porous structure were formed.	PLGA,9,13,Chemical	"[{""token"": ""PLGA"", ""start_span"": 9, ""end_span"": 13, ""type"": ""Chemical""}]"	test
The amount of conjugated amine group onto the microspheres was 1. 93 + / - 0. 01 nmol / mg - microspheres, while the amount of heparin was 95. 8 pmol / mg - microspheres.	heparin,127,134,Chemical	"[{""token"": ""heparin"", ""start_span"": 127, ""end_span"": 134, ""type"": ""Chemical""}]"	test
In addition, syndecans bind to obesity - related factors and regulate their signaling, in turn modulating food consumption and weight balance.	syndecans,13,22,Gene_or_gene_product	"[{""token"": ""syndecans"", ""start_span"": 13, ""end_span"": 22, ""type"": ""Gene_or_gene_product""}]"	test
Ovarian cancer is a highly metastatic disease.	Ovarian cancer,0,14,Cancer	"[{""token"": ""Ovarian cancer"", ""start_span"": 0, ""end_span"": 14, ""type"": ""Cancer""}]"	test
[ Study on the expression of angiogenesis and spontaneous apoptosis and their relevance in laryngeal squamous cell carcinoma]	laryngeal squamous cell carcinoma,91,124,Cancer	"[{""token"": ""laryngeal squamous cell carcinoma"", ""start_span"": 91, ""end_span"": 124, ""type"": ""Cancer""}]"	test
Expression of VEGF had a significantly positive correlation with IMVD ( r = 0. 51, P less than 0. 01).	VEGF,14,18,Gene_or_gene_product	"[{""token"": ""VEGF"", ""start_span"": 14, ""end_span"": 18, ""type"": ""Gene_or_gene_product""}]"	test
"The cancer cell ' s "" power plants "" as promising therapeutic targets: an overview."	cancer cell,4,15,Cell	"[{""token"": ""cancer cell"", ""start_span"": 4, ""end_span"": 15, ""type"": ""Cell""}]"	test
In a third approach, cancer cells are induced to die by both apoptotic and necrotic events.	cancer cells,21,33,Cell	"[{""token"": ""cancer cells"", ""start_span"": 21, ""end_span"": 33, ""type"": ""Cell""}]"	test
"In summary, much effort is being focused on identifying agents that induce "" necrotic, "" "" apoptotic "" or apoptotic plus necrotic cell death only in cancer cells."	cancer cells,149,161,Cell	"[{""token"": ""cancer cells"", ""start_span"": 149, ""end_span"": 161, ""type"": ""Cell""}]"	test
Regardless how death is inflicted, every cancer cell must die, be it fast or slow.	cancer cell,41,52,Cell	"[{""token"": ""cancer cell"", ""start_span"": 41, ""end_span"": 52, ""type"": ""Cell""}]"	test
Pathological animal models in the experimental evaluation of tumour microvasculature with magnetic resonance imaging.	tumour microvasculature,61,84,Tissue	"[{""token"": ""tumour microvasculature"", ""start_span"": 61, ""end_span"": 84, ""type"": ""Tissue""}]"	test
These parameters were correlated with histology to obtain a radiological - histological map of tumour microvasculature.	tumour microvasculature,95,118,Tissue	"[{""token"": ""tumour microvasculature"", ""start_span"": 95, ""end_span"": 118, ""type"": ""Tissue""}]"	test
CONCLUSIONS: DCE - MRI permits a noninvasive evaluation of tumour microcirculation and in particular of its dynamic characteristics and vascularity before and after antiangiogenic treatment.	tumour,59,65,Cancer	"[{""token"": ""tumour"", ""start_span"": 59, ""end_span"": 65, ""type"": ""Cancer""}]"	test
As pregnancy advanced the complexity of the vasculature increased: at 4 weeks the surface showed a pattern of ridges separated by troughs.	vasculature,44,55,Multi	"[{""token"": ""vasculature"", ""start_span"": 44, ""end_span"": 55, ""type"": ""Multi""}]"	test
Endothelial cell proliferation plays a pivotal role in the process of angiogenesis.	Endothelial cell,0,16,Cell	"[{""token"": ""Endothelial cell"", ""start_span"": 0, ""end_span"": 16, ""type"": ""Cell""}]"	test
Microvessel density and ECP% were inversely correlated ( Rho = - 0. 26, P = 0. 001).	Microvessel,0,11,Tissue	"[{""token"": ""Microvessel"", ""start_span"": 0, ""end_span"": 11, ""type"": ""Tissue""}]"	test
A pivotal role for p53: balancing aerobic respiration and glycolysis.	p53,19,22,Gene_or_gene_product	"[{""token"": ""p53"", ""start_span"": 19, ""end_span"": 22, ""type"": ""Gene_or_gene_product""}]"	test
The genetic basis of increased glycolytic activity observed in cancer cells is likely to be the result of complex interactions of multiple regulatory pathways.	cancer cells,63,75,Cell	"[{""token"": ""cancer cells"", ""start_span"": 63, ""end_span"": 75, ""type"": ""Cell""}]"	test
The biological significance of this regulation of the two major pathways of energy generation by p53 remains to be seen.	p53,97,100,Gene_or_gene_product	"[{""token"": ""p53"", ""start_span"": 97, ""end_span"": 100, ""type"": ""Gene_or_gene_product""}]"	test
CONCLUSION: Quantitative assessment is more sensitive as a measure of cellular protein content as compared with standard optical density measurements.	cellular,70,78,Cell	"[{""token"": ""cellular"", ""start_span"": 70, ""end_span"": 78, ""type"": ""Cell""}]"	test
Raising the albino mice in the dark prevented both events.	mice,19,23,Organism	"[{""token"": ""mice"", ""start_span"": 19, ""end_span"": 23, ""type"": ""Organism""}]"	test
This strategy may be of significant value in laying the foundation for a more explicit anti - tumor angiogenesis therapy.	tumor,94,99,Cancer	"[{""token"": ""tumor"", ""start_span"": 94, ""end_span"": 99, ""type"": ""Cancer""}]"	test
Thrombospondin ( TSP) - 1, a potent angiogenesis inhibitor, has been shown to exert different biological functions on various cell types.	cell,126,130,Cell	"[{""token"": ""cell"", ""start_span"": 126, ""end_span"": 130, ""type"": ""Cell""}]"	test
Management of early and advanced colorectal cancer: therapeutic issues.	colorectal cancer,33,50,Cancer	"[{""token"": ""colorectal cancer"", ""start_span"": 33, ""end_span"": 50, ""type"": ""Cancer""}]"	test
SUMMARY: Staging of colorectal cancer occurs after surgery and is based on the extent of disease invasiveness and dissemination.	colorectal cancer,20,37,Cancer	"[{""token"": ""colorectal cancer"", ""start_span"": 20, ""end_span"": 37, ""type"": ""Cancer""}]"	test
Convenience of administration, tolerability, and patient factors not necessarily age may be considerations in decisions about adjuvant therapy after resection.	patient,49,56,Organism	"[{""token"": ""patient"", ""start_span"": 49, ""end_span"": 56, ""type"": ""Organism""}]"	test
Bevacizumab in combination with chemotherapy is first - line therapy for stage IV disease.	Bevacizumab,0,11,Chemical	"[{""token"": ""Bevacizumab"", ""start_span"": 0, ""end_span"": 11, ""type"": ""Chemical""}]"	test
Age alone should not preclude the use of chemotherapy in stage IV colorectal cancer, although the ability to tolerate drug - related toxicity may be a consideration.	colorectal cancer,66,83,Cancer	"[{""token"": ""colorectal cancer"", ""start_span"": 66, ""end_span"": 83, ""type"": ""Cancer""}]"	test
Angiogenesis plays an important role in many types of cancer.	cancer,54,60,Cancer	"[{""token"": ""cancer"", ""start_span"": 54, ""end_span"": 60, ""type"": ""Cancer""}]"	test
Microscopic technique for the detection of nitric oxide - dependent angiogenesis in an animal model.	nitric oxide,43,55,Chemical	"[{""token"": ""nitric oxide"", ""start_span"": 43, ""end_span"": 55, ""type"": ""Chemical""}]"	test
Although several methods have been used for measuring in vitro angiogenesis, a proper technique has not been developed for identifying in vivo NO - dependent angiogenesis.	NO,143,145,Chemical	"[{""token"": ""NO"", ""start_span"": 143, ""end_span"": 145, ""type"": ""Chemical""}]"	test
This chapter describes intravital microscopy as a new imaging technique for detecting NO - dependent angiogenesis in an animal model.	NO,86,88,Chemical	"[{""token"": ""NO"", ""start_span"": 86, ""end_span"": 88, ""type"": ""Chemical""}]"	test
Prostaglandin E2 production was measured by enzyme linked immunosorbent assay.	Prostaglandin E2,0,16,Gene_or_gene_product	"[{""token"": ""Prostaglandin E2"", ""start_span"": 0, ""end_span"": 16, ""type"": ""Gene_or_gene_product""}]"	test
Diabetes impairs endothelial function and reparative neovascularization.	endothelial,17,28,Cell	"[{""token"": ""endothelial"", ""start_span"": 17, ""end_span"": 28, ""type"": ""Cell""}]"	test
These disturbed functions are associated with suppression of signaling mechanisms implicated in EC survival and angiogenesis.	EC,96,98,Cell	"[{""token"": ""EC"", ""start_span"": 96, ""end_span"": 98, ""type"": ""Cell""}]"	test
Collectively, our data newly demonstrate the antiangiogenic action of p75 ( NTR) and open new avenues for the therapeutic use of p75 ( NTR) inhibition to combat diabetes - induced microvascular liabilities.	microvascular,180,193,Tissue	"[{""token"": ""microvascular"", ""start_span"": 180, ""end_span"": 193, ""type"": ""Tissue""}]"	test
The expression of endostatin in situ and its maintaining time were detected by immunohistochemistry and Western Blot, respectively.	endostatin,18,28,Gene_or_gene_product	"[{""token"": ""endostatin"", ""start_span"": 18, ""end_span"": 28, ""type"": ""Gene_or_gene_product""}]"	test
The tumor apoptosis was observed by electron microscopy.	tumor,4,9,Cancer	"[{""token"": ""tumor"", ""start_span"": 4, ""end_span"": 9, ""type"": ""Cancer""}]"	test
More apoptotic tumor cells were seen under the transmission electron microscope.	tumor cells,15,26,Cell	"[{""token"": ""tumor cells"", ""start_span"": 15, ""end_span"": 26, ""type"": ""Cell""}]"	test
It is clear that this cycle functions optimally in skin of dark pigmentation.	skin,51,55,Organ	"[{""token"": ""skin"", ""start_span"": 51, ""end_span"": 55, ""type"": ""Organ""}]"	test
In this review, we outline the known mechanisms that impair p53 itself and its immediate regulators or target genes during melanomagenesis.	p53,60,63,Gene_or_gene_product	"[{""token"": ""p53"", ""start_span"": 60, ""end_span"": 63, ""type"": ""Gene_or_gene_product""}]"	test
Docetaxel has proved to be a first line treatment choice.	Docetaxel,0,9,Chemical	"[{""token"": ""Docetaxel"", ""start_span"": 0, ""end_span"": 9, ""type"": ""Chemical""}]"	test
METHODS: XTT cell proliferation assay was used for showing cytotoxicity.	XTT cell,9,17,Cell	"[{""token"": ""XTT cell"", ""start_span"": 9, ""end_span"": 17, ""type"": ""Cell""}]"	test
It was also shown by our studies that apoptosis was induced in DU - 145 prostate carcinoma cells with significant cytotoxicity, no matter which agent applied first.	DU - 145 prostate carcinoma cells,63,96,Cell	"[{""token"": ""DU - 145 prostate carcinoma cells"", ""start_span"": 63, ""end_span"": 96, ""type"": ""Cell""}]"	test
However, this modular protein core also binds with relatively high affinity to a number of growth factors and surface receptors, thereby stabilizing cell - matrix links.	cell,149,153,Cell	"[{""token"": ""cell"", ""start_span"": 149, ""end_span"": 153, ""type"": ""Cell""}]"	test
This increase was dependent on CD4 ( +) T - cell activities; however, it occurred independent of the induced eosinophilia associated with allergen provocation.	CD4,31,34,Gene_or_gene_product	"[{""token"": ""CD4"", ""start_span"": 31, ""end_span"": 34, ""type"": ""Gene_or_gene_product""}]"	test
[ Retinochoroidopathy after intravitreal anti - VEGF treatment]	VEGF,48,52,Gene_or_gene_product	"[{""token"": ""VEGF"", ""start_span"": 48, ""end_span"": 52, ""type"": ""Gene_or_gene_product""}]"	test
The diagnosis reached was retinochoroiditis as an occult manifestation of sarcoidosis, possibly resulting from an intravitreal injection of bevacizumab.	bevacizumab,140,151,Chemical	"[{""token"": ""bevacizumab"", ""start_span"": 140, ""end_span"": 151, ""type"": ""Chemical""}]"	test
Silencing of directional migration in roundabout4 knockdown endothelial cells.	roundabout4,38,49,Gene_or_gene_product	"[{""token"": ""roundabout4"", ""start_span"": 38, ""end_span"": 49, ""type"": ""Gene_or_gene_product""}]"	test
Age - related impaired wound healing leads to substantial morbidity and mortality along with a large financial burden to health services.	wound,23,28,Pathological_formation	"[{""token"": ""wound"", ""start_span"": 23, ""end_span"": 28, ""type"": ""Pathological_formation""}]"	test
Topical and systemic estrogen treatments have shown an increased rate of healing by reducing inflammation, however the underlying mechanisms are little understood.	estrogen,21,29,Chemical	"[{""token"": ""estrogen"", ""start_span"": 21, ""end_span"": 29, ""type"": ""Chemical""}]"	test
In vitro studies also suggest progesterone may play a role in modulating inflammation.	progesterone,30,42,Chemical	"[{""token"": ""progesterone"", ""start_span"": 30, ""end_span"": 42, ""type"": ""Chemical""}]"	test
Macrophages can be activated in a classical or alternative manner in parallel with the T ( H) 1 / T ( H) 2 dichotomy, respectively.	Macrophages,0,11,Cell	"[{""token"": ""Macrophages"", ""start_span"": 0, ""end_span"": 11, ""type"": ""Cell""}]"	test
In addition, densities of the newly formed bones at 16th week were studied.	bones,43,48,Organ	"[{""token"": ""bones"", ""start_span"": 43, ""end_span"": 48, ""type"": ""Organ""}]"	test
Newly formed bone densities were also found to be higher in these 2 groups.	bone,13,17,Organ	"[{""token"": ""bone"", ""start_span"": 13, ""end_span"": 17, ""type"": ""Organ""}]"	test
Correspondingly, Ang - 2 manipulatory therapies have been shown to exert protumorigenic as well as antitumorigenic effects.	Ang - 2,17,24,Gene_or_gene_product	"[{""token"": ""Ang - 2"", ""start_span"": 17, ""end_span"": 24, ""type"": ""Gene_or_gene_product""}]"	test
A remarkable delay of tumor growth and prolonged life span were also observed.	tumor,22,27,Cancer	"[{""token"": ""tumor"", ""start_span"": 22, ""end_span"": 27, ""type"": ""Cancer""}]"	test
Our previous studies mapped PEDF antiangiogenic and prosurvival activities to distinct epitopes.	PEDF,28,32,Gene_or_gene_product	"[{""token"": ""PEDF"", ""start_span"": 28, ""end_span"": 32, ""type"": ""Gene_or_gene_product""}]"	test
We analyzed their ability to block endothelial cell chemotaxis and induce apoptosis in vitro and their antiangiogenic activity in vivo.	endothelial cell,35,51,Cell	"[{""token"": ""endothelial cell"", ""start_span"": 35, ""end_span"": 51, ""type"": ""Cell""}]"	test
Endothelial cell proliferation and migration is essential to angiogenesis.	Endothelial cell,0,16,Cell	"[{""token"": ""Endothelial cell"", ""start_span"": 0, ""end_span"": 16, ""type"": ""Cell""}]"	test
Controlled neo - endothelialisation is critical to the patency of small diameter vascular grafts.	vascular grafts,81,96,Multi	"[{""token"": ""vascular grafts"", ""start_span"": 81, ""end_span"": 96, ""type"": ""Multi""}]"	test
Angiogenesis is a key event in the progression of malignant gliomas.	malignant gliomas,50,67,Cancer	"[{""token"": ""malignant gliomas"", ""start_span"": 50, ""end_span"": 67, ""type"": ""Cancer""}]"	test
Angiogenesis inhibitors have been developed to interrupt the angiogenic process at the growth factor, receptor tyrosine kinase and intracellular kinase levels.	intracellular,131,144,Immaterial_anatomical_entity	"[{""token"": ""intracellular"", ""start_span"": 131, ""end_span"": 144, ""type"": ""Immaterial_anatomical_entity""}]"	test
Most anti - angiogenic therapies for malignant gliomas are in Phase I / II trials and only modest efficacies are reported for monotherapies.	malignant gliomas,37,54,Cancer	"[{""token"": ""malignant gliomas"", ""start_span"": 37, ""end_span"": 54, ""type"": ""Cancer""}]"	test
The mechanisms that confer this rapid metastatic capacity to lung tumors are unknown.	lung tumors,61,72,Cancer	"[{""token"": ""lung tumors"", ""start_span"": 61, ""end_span"": 72, ""type"": ""Cancer""}]"	test
Angiogenesis - a novel therapeutic approach for ischemic heart disease.	heart,57,62,Organ	"[{""token"": ""heart"", ""start_span"": 57, ""end_span"": 62, ""type"": ""Organ""}]"	test
Angiogenesis is the biologic process of forming new blood vessels.	blood vessels,52,65,Multi	"[{""token"": ""blood vessels"", ""start_span"": 52, ""end_span"": 65, ""type"": ""Multi""}]"	test
Undoubtedly, blood vessels growth regulation is a vital aspect in health and disease.	blood vessels,13,26,Multi	"[{""token"": ""blood vessels"", ""start_span"": 13, ""end_span"": 26, ""type"": ""Multi""}]"	test
In many diseases state body loses control over angiogenesis.	body,23,27,Organism_subdivision	"[{""token"": ""body"", ""start_span"": 23, ""end_span"": 27, ""type"": ""Organism_subdivision""}]"	test
Angiogenesis - dependent diseases result when new blood vessels either grow excessively or insufficiently.	blood vessels,50,63,Multi	"[{""token"": ""blood vessels"", ""start_span"": 50, ""end_span"": 63, ""type"": ""Multi""}]"	test
Myocardial ischemia both acute and chronic has been clearly shown to stimulate angiogenesis in many experimental models.	Myocardial,0,10,Multi	"[{""token"": ""Myocardial"", ""start_span"": 0, ""end_span"": 10, ""type"": ""Multi""}]"	test
Therapeutic angiogenesis is the biological agents or bioactive material to stimulate the growth of new blood vessels.	blood vessels,103,116,Multi	"[{""token"": ""blood vessels"", ""start_span"": 103, ""end_span"": 116, ""type"": ""Multi""}]"	test
Use of uteroglobin for the engineering of polyvalent, polyspecific fusion proteins.	uteroglobin,7,18,Gene_or_gene_product	"[{""token"": ""uteroglobin"", ""start_span"": 7, ""end_span"": 18, ""type"": ""Gene_or_gene_product""}]"	test
We report a novel strategy to engineer and express stable and soluble human recombinant polyvalent / polyspecific fusion proteins.	human,70,75,Organism	"[{""token"": ""human"", ""start_span"": 70, ""end_span"": 75, ""type"": ""Organism""}]"	test
The procedure is based on the use of a central skeleton of uteroglobin, a small and very soluble covalently linked homodimeric protein that is very resistant to proteolytic enzymes and to pH variations.	uteroglobin,59,70,Gene_or_gene_product	"[{""token"": ""uteroglobin"", ""start_span"": 59, ""end_span"": 70, ""type"": ""Gene_or_gene_product""}]"	test
Chronic inflammation and cancer are intimately associated.	cancer,25,31,Cancer	"[{""token"": ""cancer"", ""start_span"": 25, ""end_span"": 31, ""type"": ""Cancer""}]"	test
While the understanding of the molecular pathogenesis of IBD has recently improved, the mechanisms that link these chronic inflammatory states to colorectal cancer development are in large part unknown.	colorectal cancer,146,163,Cancer	"[{""token"": ""colorectal cancer"", ""start_span"": 146, ""end_span"": 163, ""type"": ""Cancer""}]"	test
At the commencement of the study, 29 patients were in chronic phase ( CP), 25 in an accelerated phase ( AP), and 31 in the blast crisis ( BC).	patients,37,45,Organism	"[{""token"": ""patients"", ""start_span"": 37, ""end_span"": 45, ""type"": ""Organism""}]"	test
RESULTS: The expression ofVEGF protein was most pronounced in AP ( ANOVA, p = 0. 033).	ofVEGF,24,30,Gene_or_gene_product	"[{""token"": ""ofVEGF"", ""start_span"": 24, ""end_span"": 30, ""type"": ""Gene_or_gene_product""}]"	test
High expression of VEGF correlated with a shorter overall survival ( log rank, p = 0. 042).	VEGF,19,23,Gene_or_gene_product	"[{""token"": ""VEGF"", ""start_span"": 19, ""end_span"": 23, ""type"": ""Gene_or_gene_product""}]"	test
In particular, the activity of angiogenic factors is crucial for tumor progression.	tumor,65,70,Cancer	"[{""token"": ""tumor"", ""start_span"": 65, ""end_span"": 70, ""type"": ""Cancer""}]"	test
Furthermore, the biological activity of FGF - BP is neutralized by monoclonal antibodies suggesting the potential for antibody - based therapeutic targeting.	FGF - BP,40,48,Gene_or_gene_product	"[{""token"": ""FGF - BP"", ""start_span"": 40, ""end_span"": 48, ""type"": ""Gene_or_gene_product""}]"	test
Relevant differentially expressed genes were validated by either quantitative real - time polymerase chain reaction or immunohistochemistry on tissue microarrays.	tissue,143,149,Tissue	"[{""token"": ""tissue"", ""start_span"": 143, ""end_span"": 149, ""type"": ""Tissue""}]"	test
These new functions of p53 are providing interesting possibilities for the development of novel therapies.	p53,23,26,Gene_or_gene_product	"[{""token"": ""p53"", ""start_span"": 23, ""end_span"": 26, ""type"": ""Gene_or_gene_product""}]"	test
The p24 protein family have multiple functions in protein transport in the early secretory pathway.	p24 protein family,4,22,Gene_or_gene_product	"[{""token"": ""p24 protein family"", ""start_span"": 4, ""end_span"": 22, ""type"": ""Gene_or_gene_product""}]"	test
There was no effect on overall protein biosynthesis or ER stress.	ER,55,57,Gene_or_gene_product	"[{""token"": ""ER"", ""start_span"": 55, ""end_span"": 57, ""type"": ""Gene_or_gene_product""}]"	test
The 5 - year survival rate in cases with higher KISS1 protein expression was significantly higher than in those with low expression ( 20. 9 vs. 2. 4%, p < 0. 01).	KISS1,48,53,Gene_or_gene_product	"[{""token"": ""KISS1"", ""start_span"": 48, ""end_span"": 53, ""type"": ""Gene_or_gene_product""}]"	test
Expression profiling in progressive stages of fumarate - hydratase deficiency: the contribution of metabolic changes to tumorigenesis.	fumarate - hydratase,46,66,Gene_or_gene_product	"[{""token"": ""fumarate - hydratase"", ""start_span"": 46, ""end_span"": 66, ""type"": ""Gene_or_gene_product""}]"	test
We hypothesized that an additional direct consequence of FH deficiency is the establishment of a biosynthetic milieu.	FH,57,59,Gene_or_gene_product	"[{""token"": ""FH"", ""start_span"": 57, ""end_span"": 59, ""type"": ""Gene_or_gene_product""}]"	test
To investigate this hypothesis, we isolated primary mouse embryonic fibroblast ( MEF) lines from Fh1 - deficient mice.	Fh1,97,100,Gene_or_gene_product	"[{""token"": ""Fh1"", ""start_span"": 97, ""end_span"": 100, ""type"": ""Gene_or_gene_product""}]"	test
Hypermethylation was also frequently observed in a large series of bladder tumors ( 83. 1%, n = 804).	bladder tumors,67,81,Cancer	"[{""token"": ""bladder tumors"", ""start_span"": 67, ""end_span"": 81, ""type"": ""Cancer""}]"	test
KISS1 transcript expression remained an independent prognosticator in multivariate analyses ( P = 0. 017).	KISS1,0,5,Gene_or_gene_product	"[{""token"": ""KISS1"", ""start_span"": 0, ""end_span"": 5, ""type"": ""Gene_or_gene_product""}]"	test
Univariate and multivariate analyses revealed high PLD as the only independent variable predictive of neck metastasis.	neck,102,106,Organism_subdivision	"[{""token"": ""neck"", ""start_span"": 102, ""end_span"": 106, ""type"": ""Organism_subdivision""}]"	test
This desensitization was without effect upon the concentration causing half - maximal effect ( EC50), dissociation constant ( Kd) or number of PGF2 alpha receptors.	PGF2 alpha receptors,143,163,Gene_or_gene_product	"[{""token"": ""PGF2 alpha receptors"", ""start_span"": 143, ""end_span"": 163, ""type"": ""Gene_or_gene_product""}]"	test
Inhibition of PG synthesis was without effect upon desensitization, demonstrating that the effect was not agonist - induced.	PG,14,16,Chemical	"[{""token"": ""PG"", ""start_span"": 14, ""end_span"": 16, ""type"": ""Chemical""}]"	test
RESULTS: The overall incidence of BRAF mutation ( 89 / 183, 49%) was very similar to other large studies of Caucasian populations.	BRAF,34,38,Gene_or_gene_product	"[{""token"": ""BRAF"", ""start_span"": 34, ""end_span"": 38, ""type"": ""Gene_or_gene_product""}]"	test
These alterations bore similarities to abnormalities in differentiation observed in naturally occurring squamous epithelial malignancies.	squamous epithelial malignancies,104,136,Cancer	"[{""token"": ""squamous epithelial malignancies"", ""start_span"": 104, ""end_span"": 136, ""type"": ""Cancer""}]"	test
Experimental drug therapy of peritumoral brain edema.	peritumoral brain edema,29,52,Pathological_formation	"[{""token"": ""peritumoral brain edema"", ""start_span"": 29, ""end_span"": 52, ""type"": ""Pathological_formation""}]"	test
The protein and water component of brain edema were indirectly quantitated.	brain edema,35,46,Pathological_formation	"[{""token"": ""brain edema"", ""start_span"": 35, ""end_span"": 46, ""type"": ""Pathological_formation""}]"	test
None of the test drugs demonstrated significant anti - edema activity.	edema,55,60,Pathological_formation	"[{""token"": ""edema"", ""start_span"": 55, ""end_span"": 60, ""type"": ""Pathological_formation""}]"	test
Identification of a small region of the v - fos gene product that is sufficient for transforming potential and growth - stimulating activity.	v - fos,40,47,Gene_or_gene_product	"[{""token"": ""v - fos"", ""start_span"": 40, ""end_span"": 47, ""type"": ""Gene_or_gene_product""}]"	test
The reduction in collagenolytic activity was observed in viable cells as well as in conditioned medium.	cells,64,69,Cell	"[{""token"": ""cells"", ""start_span"": 64, ""end_span"": 69, ""type"": ""Cell""}]"	test
Two major type IV collagenolytic metalloproteinases exhibiting molecular weights of 64, 000 and 88, 000, respectively, were detected by this method.	metalloproteinases,33,51,Gene_or_gene_product	"[{""token"": ""metalloproteinases"", ""start_span"": 33, ""end_span"": 51, ""type"": ""Gene_or_gene_product""}]"	test
Animals were sacrificed at 3 - week intervals from 0 to 39 weeks after treatments began.	Animals,0,7,Organism	"[{""token"": ""Animals"", ""start_span"": 0, ""end_span"": 7, ""type"": ""Organism""}]"	test
Scanning electron microscopy of vascular casts was used to investigate three experimental models of neovascularization.	vascular,32,40,Multi	"[{""token"": ""vascular"", ""start_span"": 32, ""end_span"": 40, ""type"": ""Multi""}]"	test
Very little is yet known about the precise relationship of p53 to malignant transformation.	p53,59,62,Gene_or_gene_product	"[{""token"": ""p53"", ""start_span"": 59, ""end_span"": 62, ""type"": ""Gene_or_gene_product""}]"	test
The structure of the myc gene has been elucidated from studies on translocated versions of the gene.	myc,21,24,Gene_or_gene_product	"[{""token"": ""myc"", ""start_span"": 21, ""end_span"": 24, ""type"": ""Gene_or_gene_product""}]"	test
In vivo studies after dosing on Days 6, 7, and 8 demonstrated the same reductions in nucleic acid synthesis and a moderate reduction in protein synthesis.	nucleic acid,85,97,Chemical	"[{""token"": ""nucleic acid"", ""start_span"": 85, ""end_span"": 97, ""type"": ""Chemical""}]"	test
Migration of capillary endothelial cells is an important component of angiogenesis in vivo.	capillary endothelial cells,13,40,Cell	"[{""token"": ""capillary endothelial cells"", ""start_span"": 13, ""end_span"": 40, ""type"": ""Cell""}]"	test
Increased numbers of mast cells have been associated with several types of angiogenesis.	mast cells,21,31,Cell	"[{""token"": ""mast cells"", ""start_span"": 21, ""end_span"": 31, ""type"": ""Cell""}]"	test
The migration activity of mast cell conditioned medium was resistant to heat ( 100 degrees C) and incubation with proteolytic enzymes.	mast cell,26,35,Cell	"[{""token"": ""mast cell"", ""start_span"": 26, ""end_span"": 35, ""type"": ""Cell""}]"	test
In a complex organism, somatic cells are under intermittent selection pressure for the emergence of mutants that can survive environmental insults and that can grow autonomously despite adverse conditions.	somatic cells,23,36,Cell	"[{""token"": ""somatic cells"", ""start_span"": 23, ""end_span"": 36, ""type"": ""Cell""}]"	test
Repeated rounds of mutation, selection, and proliferation may lead to cancer.	cancer,70,76,Cancer	"[{""token"": ""cancer"", ""start_span"": 70, ""end_span"": 76, ""type"": ""Cancer""}]"	test
p53 - deficient cancers are often unstable, aggressive, and resistant to therapy.	p53,0,3,Gene_or_gene_product	"[{""token"": ""p53"", ""start_span"": 0, ""end_span"": 3, ""type"": ""Gene_or_gene_product""}]"	test
Although previous studies have concentrated on the effect of UV - B on the host immune response, the effect of UV - B on the tumor cells was not elucidated.	tumor cells,125,136,Cell	"[{""token"": ""tumor cells"", ""start_span"": 125, ""end_span"": 136, ""type"": ""Cell""}]"	test
Cancer metastasis: negative regulation by an invasion - suppressor complex.	Cancer,0,6,Cancer	"[{""token"": ""Cancer"", ""start_span"": 0, ""end_span"": 6, ""type"": ""Cancer""}]"	test
Invasion is the hallmark of tumor malignancy.	tumor,28,33,Cancer	"[{""token"": ""tumor"", ""start_span"": 28, ""end_span"": 33, ""type"": ""Cancer""}]"	test
Downregulation of E - cadherin occurred at the level of transcription or of mRNA stability.	E - cadherin,18,30,Gene_or_gene_product	"[{""token"": ""E - cadherin"", ""start_span"": 18, ""end_span"": 30, ""type"": ""Gene_or_gene_product""}]"	test
These observations have led to the idea that factors in the host downmodulate the E - cadherin complex and promote invasion most probably in a transient way.	E - cadherin,82,94,Gene_or_gene_product	"[{""token"": ""E - cadherin"", ""start_span"": 82, ""end_span"": 94, ""type"": ""Gene_or_gene_product""}]"	test
Analysis of the stability of HAH - cortisol showed that it was stable at pH 7. 4 and broke down rapidly ( t1 / 2 15 min) at pH 4. 8 at 37 degrees C.	HAH - cortisol,29,43,Chemical	"[{""token"": ""HAH - cortisol"", ""start_span"": 29, ""end_span"": 43, ""type"": ""Chemical""}]"	test
Daily i. v. injections of HAH - cortisol at doses causing no apparent toxicity retarded the growth of solid s. c.	HAH - cortisol,26,40,Chemical	"[{""token"": ""HAH - cortisol"", ""start_span"": 26, ""end_span"": 40, ""type"": ""Chemical""}]"	test
Hyperbaric oxygenation ( HBO) may be a useful adjuvant to wound care.	wound,58,63,Pathological_formation	"[{""token"": ""wound"", ""start_span"": 58, ""end_span"": 63, ""type"": ""Pathological_formation""}]"	test
14 diabetics with chronic nonhealing wounds which did not respond to treatment for at least 3 months were treated by HBO.	chronic nonhealing wounds,18,43,Pathological_formation	"[{""token"": ""chronic nonhealing wounds"", ""start_span"": 18, ""end_span"": 43, ""type"": ""Pathological_formation""}]"	test
In 11 there was complete wound healing, while in 1 there was partial response, in 1 minimal response, and in 1 a transient response.	wound,25,30,Pathological_formation	"[{""token"": ""wound"", ""start_span"": 25, ""end_span"": 30, ""type"": ""Pathological_formation""}]"	test
The onset of their differentiation was ascertained by the deposition of marker pteridine pigments.	pteridine,79,88,Chemical	"[{""token"": ""pteridine"", ""start_span"": 79, ""end_span"": 88, ""type"": ""Chemical""}]"	test
All the grafts older than three weeks had complete endothelialization and maintained their patency.	grafts,8,14,Multi	"[{""token"": ""grafts"", ""start_span"": 8, ""end_span"": 14, ""type"": ""Multi""}]"	test
Bone marrow with its unique native properties produced autocrine angiogenicity in the graft.	Bone marrow,0,11,Multi	"[{""token"": ""Bone marrow"", ""start_span"": 0, ""end_span"": 11, ""type"": ""Multi""}]"	test
Application of clonal analysis.	clonal,15,21,Organism	"[{""token"": ""clonal"", ""start_span"": 15, ""end_span"": 21, ""type"": ""Organism""}]"	test
The effects of radiation on neovascularization in a rat model.	rat,52,55,Organism	"[{""token"": ""rat"", ""start_span"": 52, ""end_span"": 55, ""type"": ""Organism""}]"	test
Rats that were irradiated twice ( single fractions at 0 and 24 hours after implantation) did not show a significant decrease in the neovascularization of the irradiated implant compared with the contralateral control implant.	Rats,0,4,Organism	"[{""token"": ""Rats"", ""start_span"": 0, ""end_span"": 4, ""type"": ""Organism""}]"	test
The results of this study suggest that a subclinical cumulative dose of 900 cGy is the threshold for impaired tissue revascularization provided that treatment is delivered immediately after implantation over a 48 - hour interval.	tissue,110,116,Tissue	"[{""token"": ""tissue"", ""start_span"": 110, ""end_span"": 116, ""type"": ""Tissue""}]"	test
Prognostic value of angiogenesis in operable non - small cell lung cancer.	non - small cell lung cancer,45,73,Cancer	"[{""token"": ""non - small cell lung cancer"", ""start_span"": 45, ""end_span"": 73, ""type"": ""Cancer""}]"	test
There was a significant correlation between eye appraisal and Chalkley counting ( P less than 0. 0001).	eye,44,47,Organ	"[{""token"": ""eye"", ""start_span"": 44, ""end_span"": 47, ""type"": ""Organ""}]"	test
A univariate analysis of survival showed that vascular grade was the most significant prognostic factor ( P = 0. 0004), followed by N - stage ( P = 0. 001).	vascular,46,54,Multi	"[{""token"": ""vascular"", ""start_span"": 46, ""end_span"": 54, ""type"": ""Multi""}]"	test
In a multivariate analysis, N - stage and vascular grade were not found to be independent prognostic factors, since they were strongly related to each other.	vascular,42,50,Multi	"[{""token"": ""vascular"", ""start_span"": 42, ""end_span"": 50, ""type"": ""Multi""}]"	test
Excluding N - stage, vascular grade was the only independent prognostic factor ( P = 0. 007).	vascular,21,29,Multi	"[{""token"": ""vascular"", ""start_span"": 21, ""end_span"": 29, ""type"": ""Multi""}]"	test
Forty male golden hamsters were divided into four equal groups.	golden hamsters,11,26,Organism	"[{""token"": ""golden hamsters"", ""start_span"": 11, ""end_span"": 26, ""type"": ""Organism""}]"	test
TGF alpha was studied with the appropriate antibody.	TGF alpha,0,9,Gene_or_gene_product	"[{""token"": ""TGF alpha"", ""start_span"": 0, ""end_span"": 9, ""type"": ""Gene_or_gene_product""}]"	test
Increased glycolysis is a characteristic of cancer cells.	cancer cells,44,56,Cell	"[{""token"": ""cancer cells"", ""start_span"": 44, ""end_span"": 56, ""type"": ""Cell""}]"	test
Calretinin.	Calretinin,0,10,Gene_or_gene_product	"[{""token"": ""Calretinin"", ""start_span"": 0, ""end_span"": 10, ""type"": ""Gene_or_gene_product""}]"	test
RESULTS: The diagnostic sensitivity of this new immunocytochemical approach reached 100% for the eight malignant mesotheliomas investigated.	malignant mesotheliomas,103,126,Cancer	"[{""token"": ""malignant mesotheliomas"", ""start_span"": 103, ""end_span"": 126, ""type"": ""Cancer""}]"	test
The expression of HLA - DR was correlated with the histologic type.	HLA - DR,18,26,Gene_or_gene_product	"[{""token"": ""HLA - DR"", ""start_span"": 18, ""end_span"": 26, ""type"": ""Gene_or_gene_product""}]"	test
Angiogenesis depends on growth factors and vascular cell adhesion events.	vascular cell,43,56,Cell	"[{""token"": ""vascular cell"", ""start_span"": 43, ""end_span"": 56, ""type"": ""Cell""}]"	test
These patients included many who were enrolled in the Epidermolysis Bullosa Registry and others who were referred by their physicians.	patients,6,14,Organism	"[{""token"": ""patients"", ""start_span"": 6, ""end_span"": 14, ""type"": ""Organism""}]"	test
These results suggest a novel treatment for RDEB, namely, angiogenesis inhibitors, which may antagonize the effects of bFGF in this disorder.	bFGF,119,123,Gene_or_gene_product	"[{""token"": ""bFGF"", ""start_span"": 119, ""end_span"": 123, ""type"": ""Gene_or_gene_product""}]"	test
The myoadipose flap: a new composite.	myoadipose flap,4,19,Multi	"[{""token"": ""myoadipose flap"", ""start_span"": 4, ""end_span"": 19, ""type"": ""Multi""}]"	test
Significant differences were found between the control and experimental fat pads with regard to weight and length.	fat pads,72,80,Tissue	"[{""token"": ""fat pads"", ""start_span"": 72, ""end_span"": 80, ""type"": ""Tissue""}]"	test
No vessels were visualized in the controls.	vessels,3,10,Multi	"[{""token"": ""vessels"", ""start_span"": 3, ""end_span"": 10, ""type"": ""Multi""}]"	test
We conclude that prefabrication of a fat flap is possible and may have extensive application in various areas of plastic surgery.	fat flap,37,45,Multi	"[{""token"": ""fat flap"", ""start_span"": 37, ""end_span"": 45, ""type"": ""Multi""}]"	test
This mutant enhanced the steady - level and transcriptional activity of ER.	ER,72,74,Gene_or_gene_product	"[{""token"": ""ER"", ""start_span"": 72, ""end_span"": 74, ""type"": ""Gene_or_gene_product""}]"	test
Current therapy for glioma is suboptimal.	glioma,20,26,Cancer	"[{""token"": ""glioma"", ""start_span"": 20, ""end_span"": 26, ""type"": ""Cancer""}]"	test
