Sentence	entity_1	json	split
Sample processing DNA extraction DNA was extracted using Qiagen ' s DNeasy Plant Kit ( Germantown, Maryland, USA) with some modifications to manufacturer ' s instructions.	Qiagen ' s DNeasy Plant Kit,57,84,kit	"[{""token"": ""Qiagen ' s DNeasy Plant Kit"", ""start_span"": 57, ""end_span"": 84, ""type"": ""kit""}]"	test
DNA extraction DNA was extracted using the MO BIO Laboratories PowerSoil DNA Isolation Kit ( Carlsbad, CA).	MO BIO Laboratories PowerSoil DNA Isolation Kit,43,90,kit	"[{""token"": ""MO BIO Laboratories PowerSoil DNA Isolation Kit"", ""start_span"": 43, ""end_span"": 90, ""type"": ""kit""}]"	test
Environmental DNA from Trap and native Basalt samples was extracted with using the Ultraclean Soil DNA extraction kit ( MoBio Laboratories).	Ultraclean Soil DNA extraction kit,83,117,kit	"[{""token"": ""Ultraclean Soil DNA extraction kit"", ""start_span"": 83, ""end_span"": 117, ""type"": ""kit""}]"	test
DNA was extracted from the frozen cell pellets, using the FastDNA SPIN kit for soil ( MP Biomedicals, Illkirch, France).	FastDNA SPIN kit for soil,58,83,kit	"[{""token"": ""FastDNA SPIN kit for soil"", ""start_span"": 58, ""end_span"": 83, ""type"": ""kit""}]"	test
Total DNA and RNA were extracted at the same time from the same filter using the NucleoSpin RNA L kit ( Macherey - Nagel, Dren, Germany).	NucleoSpin RNA L kit,81,101,kit	"[{""token"": ""NucleoSpin RNA L kit"", ""start_span"": 81, ""end_span"": 101, ""type"": ""kit""}]"	test
16S rRNA Gene Amplicon Sequencing DNA was extracted from the initial activated sludge as well as from enrichment cultures at the final incubation time point using FastDNA Extraction Kit for Soil ( MP Biomedicals, Santa Ana, CA, United States) according to the instruction manual.	FastDNA Extraction Kit for Soil,163,194,kit	"[{""token"": ""FastDNA Extraction Kit for Soil"", ""start_span"": 163, ""end_span"": 194, ""type"": ""kit""}]"	test
Nucleic acids were extracted from the recovered cell pellets using the Fast DNA SPIN Kit for soil ( MP Biomedicals, USA) according to manufacturers instructions.	Fast DNA SPIN Kit,71,88,kit	"[{""token"": ""Fast DNA SPIN Kit"", ""start_span"": 71, ""end_span"": 88, ""type"": ""kit""}]"	test
Microbial Community Analysis DNA was extracted using a soil total DNA kit ( MP Biomedicals, Solon, OH, USA) in accordance with the manufacturers instructions.	soil total DNA kit,55,73,kit	"[{""token"": ""soil total DNA kit"", ""start_span"": 55, ""end_span"": 73, ""type"": ""kit""}]"	test
Genomic DNA extraction from the nine sampling points ( P0 to P8) was performed using Fast DNA SPIN kit for soil ( MP Biomedicals, Solon, OH) following the manufacturers protocol with additional washing steps before starting to the extraction.	Fast DNA SPIN kit,85,102,kit	"[{""token"": ""Fast DNA SPIN kit"", ""start_span"": 85, ""end_span"": 102, ""type"": ""kit""}]"	test
DNA extraction, PCR amplification, and sequencing Total bacterial DNA from the luminal samples was extracted using a Soil GenomeTM DNA Isolation kit ( Qiagen, Germany), according to the manufacturer instructions.	Soil GenomeTM DNA Isolation kit,117,148,kit	"[{""token"": ""Soil GenomeTM DNA Isolation kit"", ""start_span"": 117, ""end_span"": 148, ""type"": ""kit""}]"	test
For RT - PCR, total RNA from the remaining spinal cord sample was extracted using a Qiagen RNeasy Plus Micro Kit with RNA carrier ( Hilden, GER) to facilitate RNA pull - down from this small tissue.	Qiagen RNeasy Plus Micro Kit,84,112,kit	"[{""token"": ""Qiagen RNeasy Plus Micro Kit"", ""start_span"": 84, ""end_span"": 112, ""type"": ""kit""}]"	test
DNA extraction DNA was extracted from all samples using the MO BIO Laboratories UltraClean DNA Isolation Kit ( Carlsbad, CA).	UltraClean DNA Isolation Kit,80,108,kit	"[{""token"": ""UltraClean DNA Isolation Kit"", ""start_span"": 80, ""end_span"": 108, ""type"": ""kit""}]"	test
DNA was extracted using an UltraClean soil DNA isolation kit ( MoBIO Laboratories, Carlsbad, CA).	UltraClean soil DNA isolation kit,27,60,kit	"[{""token"": ""UltraClean soil DNA isolation kit"", ""start_span"": 27, ""end_span"": 60, ""type"": ""kit""}]"	test
RNA was extracted using the RNeasy MiniKit ( Qiagen) according to manufacturer instructions, with additional steps for cell disruption through flash - freezing and bead - beating filters in mixtures of 500 L RLT buffer, 5 L - mercaptoethanol, and 200 L of mixed 0. 1 mm and 0. 5 mm glass beads ( Biospec products).	RNeasy MiniKit,28,42,kit	"[{""token"": ""RNeasy MiniKit"", ""start_span"": 28, ""end_span"": 42, ""type"": ""kit""}]"	test
In brief, stool samples were collected, and approximately 2ml of stool was homogenized by vortexing in 5ml of MO BIO lysis buffer ( PowerLyzer PowerSoil Bead solution, MO BIO Laboratories).	PowerLyzer PowerSoil,132,152,kit	"[{""token"": ""PowerLyzer PowerSoil"", ""start_span"": 132, ""end_span"": 152, ""type"": ""kit""}]"	test
DNA was extracted using a PowerSoil DNA Isolation Kit ( MoBio Laboratories, Inc., Carlsbad, CA, USA) according to the manufacturer ' s instructions.	PowerSoil DNA Isolation Kit,26,53,kit	"[{""token"": ""PowerSoil DNA Isolation Kit"", ""start_span"": 26, ""end_span"": 53, ""type"": ""kit""}]"	train
DNA extraction and sequencing DNA was extracted from M - Core sediment and water samples using the MoBio PowerMax soil DNA isolation kit, according to manufacturer protocols ( ~ 5 g slurry / extraction).	MoBio PowerMax soil DNA isolation kit,99,136,kit	"[{""token"": ""MoBio PowerMax soil DNA isolation kit"", ""start_span"": 99, ""end_span"": 136, ""type"": ""kit""}]"	train
RNA was isolated using the InnuSPEED Bacteria / Fungi RNA Kit ( Analytic Jena) according to the manufacturers guidelines.	InnuSPEED Bacteria / Fungi RNA Kit,27,61,kit	"[{""token"": ""InnuSPEED Bacteria / Fungi RNA Kit"", ""start_span"": 27, ""end_span"": 61, ""type"": ""kit""}]"	train
DNA extracts were purified with the DNA Clean and Concentrator - 5 kit ( Zymo Research, CA, USA) according to the manufacturer ' s instructions.	DNA Clean and Concentrator - 5 kit,36,70,kit	"[{""token"": ""DNA Clean and Concentrator - 5 kit"", ""start_span"": 36, ""end_span"": 70, ""type"": ""kit""}]"	train
DNA was extracted using the Fast DNA Spin Kit for Soil ( MP Biomedicals) as per the manufacturers instructions and quantified with a Qubit fluorometer ( Invitrogen), using the Quant - iTTM dsDNA HS Assay Kit ( Invitrogen).	Fast DNA Spin Kit,28,45,kit	"[{""token"": ""Fast DNA Spin Kit"", ""start_span"": 28, ""end_span"": 45, ""type"": ""kit""}]"	train
In detail, genomic DNA was extracted from bacteria using DNeasy Blood and Tissue Kit ( Qiagen, SA, Courtaboeuf, France), according to the manufacturer ' s instructions ( Ahmed et al., 2009).	DNeasy Blood and Tissue Kit,57,84,kit	"[{""token"": ""DNeasy Blood and Tissue Kit"", ""start_span"": 57, ""end_span"": 84, ""type"": ""kit""}]"	train
DNA isolation and purification Genomic DNA was extracted using the DNeasy PowerLyzer PowerSoil Kit ( Qiagen, Venlo, the Netherlands) following the manufacturers instructions.	DNeasy PowerLyzer PowerSoil Kit,67,98,kit	"[{""token"": ""DNeasy PowerLyzer PowerSoil Kit"", ""start_span"": 67, ""end_span"": 98, ""type"": ""kit""}]"	train
DNA isolation was done using a FastDNA SPIN Kit for Soil ( MP Biomedicals).	FastDNA SPIN Kit,31,47,kit	"[{""token"": ""FastDNA SPIN Kit"", ""start_span"": 31, ""end_span"": 47, ""type"": ""kit""}]"	train
Each BSC sample was weighed ~ 1 g. DNA for the cryptoendolithic and soil crust samples was extracted using the PowerMax Soil DNA Isolation kit ( Mo Bio Laboratories, Carlsbad, CA, USA) following manufacturers protocol.	PowerMax Soil DNA Isolation kit,111,142,kit	"[{""token"": ""PowerMax Soil DNA Isolation kit"", ""start_span"": 111, ""end_span"": 142, ""type"": ""kit""}]"	train
DNA extraction, amplification and sequencing DNA was extracted using the Power Biofilm DNA Isolation Kit ( MoBio, Carlsbad, CA, USA) according to manufacturers instructions.	Power Biofilm DNA Isolation Kit,73,104,kit	"[{""token"": ""Power Biofilm DNA Isolation Kit"", ""start_span"": 73, ""end_span"": 104, ""type"": ""kit""}]"	train
The PowerSoil DNA Isolation Kit ( MO BIO Laboratories, Inc.) was used for fecal DNA extraction, according to the manufacturers protocol.	PowerSoil DNA Isolation Kit,4,31,kit	"[{""token"": ""PowerSoil DNA Isolation Kit"", ""start_span"": 4, ""end_span"": 31, ""type"": ""kit""}]"	train
Nucleic acid was extracted from 50 L of spinal cords lysate with the Direct - zol RNA Kit ( Zymo Research, Irvine, CA) or 50 L virus culture using the automated Qiagen EZ1 robotic instrument ( Qiagen, Valencia, CA), followed by treatment with Turbo DNase, then randomly reverse transcribed to cDNA with random hexamer primers.	Direct - zol RNA Kit,69,89,kit	"[{""token"": ""Direct - zol RNA Kit"", ""start_span"": 69, ""end_span"": 89, ""type"": ""kit""}]"	train
DNA extractions from stool were carried out using the QIAamp DNA Stool Mini Kit ( QIAGEN).	QIAamp DNA Stool Mini Kit,54,79,kit	"[{""token"": ""QIAamp DNA Stool Mini Kit"", ""start_span"": 54, ""end_span"": 79, ""type"": ""kit""}]"	train
DNA stored on filters ( lakes, snow) was extracted using the PowerWater DNA Isolation kit ( MoBio Laboratories).	PowerWater DNA Isolation kit,61,89,kit	"[{""token"": ""PowerWater DNA Isolation kit"", ""start_span"": 61, ""end_span"": 89, ""type"": ""kit""}]"	train
DNA extraction and MAG construction Genomic DNA was extracted from subsamples ( ~ 1. 0 g) of the inactive chimney by a modified method using the UltraClean Soil DNA Isolation Kit ( MoBio Laboratories, Carlsbad, CA, USA) as previously described ( 34).	UltraClean Soil DNA Isolation Kit,145,178,kit	"[{""token"": ""UltraClean Soil DNA Isolation Kit"", ""start_span"": 145, ""end_span"": 178, ""type"": ""kit""}]"	train
The FastDNA spin kit for soil and the FastPrep - 24 Instrument ( MP Biomedicals, Santa Ana, CA, USA) was used for DNA extractions of chimney and sediment sections.	The FastDNA spin kit,0,20,kit	"[{""token"": ""The FastDNA spin kit"", ""start_span"": 0, ""end_span"": 20, ""type"": ""kit""}]"	train
DNA extraction Fecal samples were thawed on ice and DNA extraction was performed using the QIAamp DNA Stool Mini Kit ( Qiagen, Valencia, CA, USA).	QIAamp DNA Stool Mini Kit,91,116,kit	"[{""token"": ""QIAamp DNA Stool Mini Kit"", ""start_span"": 91, ""end_span"": 116, ""type"": ""kit""}]"	train
DNeasy PowerSoil Kit ( QIAGEN, Germany) was used for genomic DNA extraction with minor modifications ( purification with 1mL of Phe: Chl: IAA pH 8, Sigma - Aldrich, DK).	DNeasy PowerSoil Kit,0,20,kit	"[{""token"": ""DNeasy PowerSoil Kit"", ""start_span"": 0, ""end_span"": 20, ""type"": ""kit""}]"	train
Microbial genomic DNA was extracted using the PowerSoil DNA isolation kit ( MO BIO Laboratories), according to the manufacturers instructions.	PowerSoil DNA isolation kit,46,73,kit	"[{""token"": ""PowerSoil DNA isolation kit"", ""start_span"": 46, ""end_span"": 73, ""type"": ""kit""}]"	train
The filtered liquid was then extracted using the Qiagen All - Prep kit following manufacturers protocol.	Qiagen All - Prep kit,49,70,kit	"[{""token"": ""Qiagen All - Prep kit"", ""start_span"": 49, ""end_span"": 70, ""type"": ""kit""}]"	train
DNA was extracted using the PowerWater DNA extraction kit ( Mobio, Carlsbad, CA, USA).	PowerWater DNA extraction kit,28,57,kit	"[{""token"": ""PowerWater DNA extraction kit"", ""start_span"": 28, ""end_span"": 57, ""type"": ""kit""}]"	train
A 200 l aliquot of NP sample was transferred to 6 ml Supplemented Todd - Hewitt Broth ( THB) containing 0. 5% yeast extract and 17% rabbit ( Philippines) or fetal bovine ( South Africa) serum and 10 mg / ml colistin and incubated at 37 C at 5% CO2 without shaking for 6 h. Cells were then centrifuged at 9, 000 rpm for 10 min and frozen at 20 C. Metagenomic DNA was extracted from this pellet using Qiagen DNeasy Blood and Tissue kit ( Qiagen) following manufacturer ' s instructions.	Qiagen DNeasy Blood and Tissue kit,399,433,kit	"[{""token"": ""Qiagen DNeasy Blood and Tissue kit"", ""start_span"": 399, ""end_span"": 433, ""type"": ""kit""}]"	train
DNA was extracted using the FastDNA Spin Kit for Soil ( MP Biomedicals) following the manufacturers protocol, from 4612mg of biomass ( wet weight) per sample.	FastDNA Spin Kit for Soil,28,53,kit	"[{""token"": ""FastDNA Spin Kit for Soil"", ""start_span"": 28, ""end_span"": 53, ""type"": ""kit""}]"	train
DNA extraction and sequencing Genomic DNA from sponge tissue ( 0. 5 g) was extracted using the PrecellysEvolution homogenizer ( Bertin Technologies, Montigny - Le - Bretonneux, France) and a Power - Soil DNA Isolation Kit ( MOBIO, Germantown, MD, USA), following the manufacturers instructions.	Power - Soil DNA Isolation Kit,191,221,kit	"[{""token"": ""Power - Soil DNA Isolation Kit"", ""start_span"": 191, ""end_span"": 221, ""type"": ""kit""}]"	train
Samples were transferred into 2. 5ml IsoylRNA Lysis reagent ( 5 Prime GmbH, Hilden, Germany) and RNA was extracted applying the Directzol RNA Kit ( Zymo Research, Freiburg, Germany).	Directzol RNA Kit,128,145,kit	"[{""token"": ""Directzol RNA Kit"", ""start_span"": 128, ""end_span"": 145, ""type"": ""kit""}]"	train
The RNA sample was further purified by RNeasy Mini Kit ( QIAGEN) following the specific protocols.	RNeasy Mini Kit,39,54,kit	"[{""token"": ""RNeasy Mini Kit"", ""start_span"": 39, ""end_span"": 54, ""type"": ""kit""}]"	train
1Reaches of the four Brazilian rivers featured in this study indicating floodplain lake sampling sites: Amazon ( a), Araguaia ( b), Pantanal ( c), and Parana ( d) Molecular Analysis Environmental DNA ( eDNA) was extracted with FastDNA kits ( MP Biomedicals, Solon, OH) and quantified using the dsDNA High Sensitivity Assay kit on the Qubit 2. 0 Fluorometer ( Invitrogen, Waltham, MA).	FastDNA kits,227,239,kit	"[{""token"": ""FastDNA kits"", ""start_span"": 227, ""end_span"": 239, ""type"": ""kit""}]"	train
Using stool from five healthy non - HMP donors, we compared fungal diversity and taxonomy using the HMP method of microbial DNA extraction ( MO BIO PowerSoil DNA Isolation Kit) and a modified version of this protocol that is similar to what other investigators have used [ 21, 38, 54, 55].	PowerSoil DNA Isolation Kit,148,175,kit	"[{""token"": ""PowerSoil DNA Isolation Kit"", ""start_span"": 148, ""end_span"": 175, ""type"": ""kit""}]"	train
The DNA was extracted from AD sludge using the FastDNA Spin kit for soil ( MP Biomedicals, Santa Ana, CA, United States) following the standard protocol with minor modifications, as recommended by Albertsen et al. ( 2015).	FastDNA Spin kit for soil,47,72,kit	"[{""token"": ""FastDNA Spin kit for soil"", ""start_span"": 47, ""end_span"": 72, ""type"": ""kit""}]"	train
Further DNA extraction steps were performed using the standard protocol from the MO BIO PowerSoil DNA Isolation Kit.	PowerSoil DNA Isolation Kit,88,115,kit	"[{""token"": ""PowerSoil DNA Isolation Kit"", ""start_span"": 88, ""end_span"": 115, ""type"": ""kit""}]"	train
DNA was extracted and purified using a PowerSoil DNA isolation kit ( MoBio Laboratories, Carlsbad, CA) according to the manufacturers protocol with some modifications.	PowerSoil DNA isolation kit,39,66,kit	"[{""token"": ""PowerSoil DNA isolation kit"", ""start_span"": 39, ""end_span"": 66, ""type"": ""kit""}]"	train
Afterward, the genomic DNA was extracted from the washed biomass using the DNeasy PowerLyzer PowerSoil Kit ( Qiagen) following the manufacturer ' s instructions.	DNeasy PowerLyzer PowerSoil Kit,75,106,kit	"[{""token"": ""DNeasy PowerLyzer PowerSoil Kit"", ""start_span"": 75, ""end_span"": 106, ""type"": ""kit""}]"	train
DNA Extraction and Sequence Analysis DNA was extracted using a Qiagen Powersoil kit ( QIAGEN, Germantown, MD, United States) following the manufacturers protocol after removing Lifeguard.	Qiagen Powersoil kit,63,83,kit	"[{""token"": ""Qiagen Powersoil kit"", ""start_span"": 63, ""end_span"": 83, ""type"": ""kit""}]"	train
Faecal and cecal bacterial DNA extraction Faecal samples were subjected to DNA extraction using the QIAmp DNA Stool Mini Kit following the manufacturers instructions ( Qiagen).	QIAmp DNA Stool Mini Kit,100,124,kit	"[{""token"": ""QIAmp DNA Stool Mini Kit"", ""start_span"": 100, ""end_span"": 124, ""type"": ""kit""}]"	train
Viral RNA was extracted from 500 to 1, 000 l of plasma and 500l of CVL supernatant using a QIAamp Viral RNA Mini Kit ( Qiagen) according to the manufacturers instructions, including a step for on - column DNase.	QIAamp Viral RNA Mini Kit,91,116,kit	"[{""token"": ""QIAamp Viral RNA Mini Kit"", ""start_span"": 91, ""end_span"": 116, ""type"": ""kit""}]"	train
DNA was extracted from the pellets using the NucleoSpinSoil Kit ( MACHEREY - NAGEL GmbH & Co., KG, Germany, buffer SL2, no enhancer).	NucleoSpinSoil Kit,45,63,kit	"[{""token"": ""NucleoSpinSoil Kit"", ""start_span"": 45, ""end_span"": 63, ""type"": ""kit""}]"	train
Total genomic DNA was prepared with the FastDNA Spin kit for Soil ( MP Biomedicals, Santa Ana, CA).	FastDNA Spin kit,40,56,kit	"[{""token"": ""FastDNA Spin kit"", ""start_span"": 40, ""end_span"": 56, ""type"": ""kit""}]"	train
DNA was extracted from yeasts using the Wizard Genomic DNA Purification kit ( Promega Corporation, Madison, WI), according to the manufacturer ' s instructions ( Soteropoulos and Perlin, 1998).	Wizard Genomic DNA Purification kit,40,75,kit	"[{""token"": ""Wizard Genomic DNA Purification kit"", ""start_span"": 40, ""end_span"": 75, ""type"": ""kit""}]"	train
DNA extraction, 16S rDNA amplification, and amplicon sequencing Bacterial genomic DNA was isolated and purified with the QiaAmp Mini DNAIsolation Kit ( Qiagen, Hilden, Germany), as described previously. 11 Library preparation was performed with two rounds of amplification following the 16S metagenomics sequencing library preparation guide ( Part # 15044223 Rev. B, Illumina GmbH, Munich, Germany). 11 Up to 96 libraries were normalized and pooled for an Illumina MiSeq sequencing run using the Illumina MiSeq Reagent Kit version ( v.) 3 with marginally overlapping 300bp pairedend reads.	QiaAmp Mini DNAIsolation Kit,121,149,kit	"[{""token"": ""QiaAmp Mini DNAIsolation Kit"", ""start_span"": 121, ""end_span"": 149, ""type"": ""kit""}]"	train
The T11, T25, and T45 ( duplicate samples of T45 were extracted and sequenced) time points were extracted with the MoBio PowerSoil DNA isolation kit, according to manufacturer protocols ( ~ 0. 5 g / extraction).	MoBio PowerSoil DNA isolation kit,115,148,kit	"[{""token"": ""MoBio PowerSoil DNA isolation kit"", ""start_span"": 115, ""end_span"": 148, ""type"": ""kit""}]"	train
DNA extraction was done using the PowerSoil kit ( Mo Bio), as described previously ( 7).	PowerSoil kit,34,47,kit	"[{""token"": ""PowerSoil kit"", ""start_span"": 34, ""end_span"": 47, ""type"": ""kit""}]"	train
To extract DNA from the samples, an ISOL for Beads Beating kit ( Nippon Gene, Tokyo, Japan) was used according to the manufacturers protocol.	Beads Beating kit,45,62,kit	"[{""token"": ""Beads Beating kit"", ""start_span"": 45, ""end_span"": 62, ""type"": ""kit""}]"	train
DNA was extracted using a modified DNeasy Plant Mini Kit ( Qiagen) protocol, described in detail in ref.	DNeasy Plant Mini Kit,35,56,kit	"[{""token"": ""DNeasy Plant Mini Kit"", ""start_span"": 35, ""end_span"": 56, ""type"": ""kit""}]"	train
DNA extraction and sequencing Details of clinical sample collection are provided in Additionalfile2: Supplementary Methods; 100150mg of formed or 100L of loose stool was subjected to 5min of bead beating and DNA was extracted using easyMAG ( bioMerieux, Marcie - lEtoile, France).	easyMAG,232,239,kit	"[{""token"": ""easyMAG"", ""start_span"": 232, ""end_span"": 239, ""type"": ""kit""}]"	train
DNA was subsequently extracted with the QIAamp DNA Stool Mini Kit ( Qiagen, Valencia, CA, USA).	QIAamp DNA Stool Mini Kit,40,65,kit	"[{""token"": ""QIAamp DNA Stool Mini Kit"", ""start_span"": 40, ""end_span"": 65, ""type"": ""kit""}]"	train
Pyrosequencing and data analysis Total DNA extraction from faecal samples ( 250mg, wet weight) was performed using the FastDNA SPIN Kit for Feces ( MP Biomedicals, Santa Ana, CA, USA) following manufacturers instructions.	FastDNA SPIN Kit,119,135,kit	"[{""token"": ""FastDNA SPIN Kit"", ""start_span"": 119, ""end_span"": 135, ""type"": ""kit""}]"	train
16S rRNA gene sequencing DNA from stool and intestinal contents ( QIAamp DNA Stool Mini Kit, Germany) was amplified using barcoded V3V4 region primers targeting the bacterial 16S rRNA gene, sequenced using the Illumina MiSeq platform ( Illumina, San Diego, CA, USA), analyzed using QIIME, and assessed by multiple parameters with STAMP software.	QIAamp DNA Stool Mini Kit,66,91,kit	"[{""token"": ""QIAamp DNA Stool Mini Kit"", ""start_span"": 66, ""end_span"": 91, ""type"": ""kit""}]"	train
DNA extractions were performed using the UltraClean DNA isolation kit ( MO BIO Laboratories, CA, USA).	UltraClean DNA isolation kit,41,69,kit	"[{""token"": ""UltraClean DNA isolation kit"", ""start_span"": 41, ""end_span"": 69, ""type"": ""kit""}]"	train
Isolation of nucleic acids and 454 pyrosequencing DNA was isolated and 454 pyrosequencing was performed as previously described32 Briefly, DNA was isolated from 3mg of snap frozen tissue using the QIAmp DNA Stool Kit ( Qiagen, Valencia, CA) following the manufacturer ' s instructions.	QIAmp DNA Stool Kit,197,216,kit	"[{""token"": ""QIAmp DNA Stool Kit"", ""start_span"": 197, ""end_span"": 216, ""type"": ""kit""}]"	train
Fecal DNA was extracted using the PowerSoil DNA Isolation Kit ( MOBIO, West Carlsbad, CA) according to the manufacturers protocol.	PowerSoil DNA Isolation Kit,34,61,kit	"[{""token"": ""PowerSoil DNA Isolation Kit"", ""start_span"": 34, ""end_span"": 61, ""type"": ""kit""}]"	train
Hydrocarbon activation gene analysis Pelleted cells from subsampled culture fluids were extracted for genomic DNA using the FastDNA SPIN Kit for Soils ( MP Biomedicals) and normalized to a concentration of 0. 5 ng / L. Each DNA extract was then probed for the presence of anaerobic hydrocarbon activation genes using a series of established primer sets and thermocycling conditions ( Table 1).	FastDNA SPIN Kit for Soils,124,150,kit	"[{""token"": ""FastDNA SPIN Kit for Soils"", ""start_span"": 124, ""end_span"": 150, ""type"": ""kit""}]"	train
For the isolated strains showing wide - spectrum QQ activity, genomic DNA was extracted using a Wizard DNA purification Kit ( Promega, Madison, WI, USA), and the bacterial 16S rRNA gene was amplified using the universal primers 96 bfm ( 5 - GAGTTTGATYHTGGCTCAG - 3) and 1152 uR ( 5 - ACGGHTACCTTGTTACGACTT - 3) [ 59].	Wizard DNA purification Kit,96,123,kit	"[{""token"": ""Wizard DNA purification Kit"", ""start_span"": 96, ""end_span"": 123, ""type"": ""kit""}]"	train
DNA was extracted with QIAamp DNA Blood Midi kit ( Qiagen, Helden, Germany) in a Class II Biological Safety Cabinet to avoid external contamination.	QIAamp DNA Blood Midi kit,23,48,kit	"[{""token"": ""QIAamp DNA Blood Midi kit"", ""start_span"": 23, ""end_span"": 48, ""type"": ""kit""}]"	train
Microbial DNA was isolated via the PowerSoil DNA Isolation Kit ( MOBIO, Carlsbad, CA).	PowerSoil DNA Isolation Kit,35,62,kit	"[{""token"": ""PowerSoil DNA Isolation Kit"", ""start_span"": 35, ""end_span"": 62, ""type"": ""kit""}]"	train
DNA was isolated from tissues using the DNeasy Blood and Tissue Kit ( Qiagen) following the manufacturer ' s instructions.	DNeasy Blood and Tissue Kit,40,67,kit	"[{""token"": ""DNeasy Blood and Tissue Kit"", ""start_span"": 40, ""end_span"": 67, ""type"": ""kit""}]"	train
Total genomic DNA was extracted in triplicate using the FastDNA Spin kit for soil ( MP Biomedicals, Santa Ana, CA, USA) according to the manufacturers instructions, with the modifications that aliquots of 200L digester sample were used for extraction and 60L water was used in the final DNA elution.	FastDNA Spin kit,56,72,kit	"[{""token"": ""FastDNA Spin kit"", ""start_span"": 56, ""end_span"": 72, ""type"": ""kit""}]"	train
RNA was extracted from the samples using an RNeasy kit ( Qiagen, Valencia, CA, USA) with a DNase digestion step.	RNeasy kit,44,54,kit	"[{""token"": ""RNeasy kit"", ""start_span"": 44, ""end_span"": 54, ""type"": ""kit""}]"	train
In brief, genomic DNA was extracted from the 0. 2 m polycarbonate filters with the DNeasy Tissue kit ( Qiagen Gmbh Hilden, Germany) and amplified using HPLC purified PCR primers.	DNeasy Tissue kit,83,100,kit	"[{""token"": ""DNeasy Tissue kit"", ""start_span"": 83, ""end_span"": 100, ""type"": ""kit""}]"	train
RNA was extracted by using the commercial kit FastRNA Pro Soil - Direct kit ( MP Biomedicals, Solon, OH) and following the manufacturers instructions.	FastRNA Pro Soil - Direct kit,46,75,kit	"[{""token"": ""FastRNA Pro Soil - Direct kit"", ""start_span"": 46, ""end_span"": 75, ""type"": ""kit""}]"	train
The sample sites and environmental parameters are also shown in Table2. Table1The influent and effluent water qualities of WWTPsWWTPs ( process) BOD ( mg / L) COD ( mg / L) T - N ( mg / L) T - N removalNH4 + N removalInfluent B / CInfluent COD / T - NInfluent COD / NH4 + NRemarksQige WWTP ( A / A / O) Influent18022045055026. 4268. 50% 94% 0. 47 > 9. 0916. 67Domestic sewage treatmentEffluent2. 57. 513358. 3Shangyu WWTP ( A / O) Influent120160400450354050. 00% 95. 40% 0. 3211. 312. 96Fine chemical industry wastewaterEffluent101580921621Shaoxing WWTP - I ( A / O) Influent1371606336617442. 30% 99. 25% 0. 234. 99. 3Textile dyeing industry wastewaterEffluent2. 1313606542. 7Shaoxing WWTP - II ( oxidation ditch) Influent10421146268873. 634. 40% 97. 50% 0. 2746. 610. 55Effluent9. 712. 55415448. 3Shaoxing WWTP - III ( oxidation ditch) InfluentThe same with Shaoxing39. 86% 99. 25% 0. 234. 99. 3Effluent2. 1313606544. 5WWTP - I, the first phase project; WWTP - II, the second phase project; WWTP - II, the third phase project; BOD, Biological Oxygen Demand ( mg / l); COD, chemical oxygen demand ( mg / l); T - N, total nitrogen concentration ( mg / l); T - P, total phosphorus concentration; NH4 + N, ammonium nitrogen Table2Description of samples collected and important WWTP parametersDate2015 / 8 / 152015 / 8 / 172015 / 8 / 18Temperature ( C) 2832323232WWTP nameQige WWTPShangyu WWTPShaoxing WWTP IShaoxing WWTP - IIShaoxing WWTP - IIISampling siteAnaerobic tankAnoxic tankAeration tankAnaerobic tankAeration tankAnaerobic tankAeration tankOxidation ditchOxidation ditchCodeQG - AnaQG - AnoQG - OSY - ASY - OSX - 1 - ASX - I - OSX - II ( OD) SX - III ( OD) Valid tank volume ( m3) 579222, 01043, 443964036, 73044, 640216, 691818, 670302, 000Hydraulic retention time ( h) 13. 87. 54. 1115. 678. 51543. 640. 3Sludge retention time ( days) 151861415221017pH value on sample7. 57. 47. 218. 187. 927. 497. 627. 37. 9 DNA extraction In this study, High molecular weight community DNA was extracted by the freeze - grinding, SDS - based method and was purified using a commercialized DNA isolation kit ( e. g. E. Z. N. A., Omega, Norcross, Georgia, US) ( Zhang et al. 2017).	commercialized DNA isolation kit,2068,2100,kit	"[{""token"": ""commercialized DNA isolation kit"", ""start_span"": 2068, ""end_span"": 2100, ""type"": ""kit""}]"	train
Viral DNA was extracted using the Wizard prep PCR purification kit with 0. 5 ml sample added to the 1ml resin and eluted on Wizard mini - columns with TE buffer ( 10 mM Tris, pH 7. 5, 1 mM EDTA) ( Promega, Fitchburg, WI, USA).	Wizard prep PCR purification kit,34,66,kit	"[{""token"": ""Wizard prep PCR purification kit"", ""start_span"": 34, ""end_span"": 66, ""type"": ""kit""}]"	train
Aqueous Fe and S2 were measured using colorimetric methods ( ferrozine and methylene blue assays, respectively), while sediment - water slurries were used for total DNA extractions ( MoBio Powersoil DNA extraction kit, MoBio, CA, USA).	MoBio Powersoil DNA extraction kit,183,217,kit	"[{""token"": ""MoBio Powersoil DNA extraction kit"", ""start_span"": 183, ""end_span"": 217, ""type"": ""kit""}]"	train
RNA extraction from the biomass pellet was performed using the RNeasy Midi Kit ( Qiagen, Hilden, Germany) following manufacturer ' s protocol and RNA concentration was measured with the Invitrogen RNA HS Qubit 2. 0 assay kit ( Thermo Fisher Scientific, Carlsbad, CA).	RNeasy Midi Kit,63,78,kit	"[{""token"": ""RNeasy Midi Kit"", ""start_span"": 63, ""end_span"": 78, ""type"": ""kit""}]"	train
DNA extraction DNA was extracted from the filters using a phenol / chloroform - based protocol.	phenol / chloroform - based,58,85,kit	"[{""token"": ""phenol / chloroform - based"", ""start_span"": 58, ""end_span"": 85, ""type"": ""kit""}]"	train
DNA extraction, PCR, and pyrosequencing DNA was extracted from the microbial mats using the MasterPure Complete DNA and RNA Purification Kit ( Epicentre Biotechnologies, Madison, WI, USA).	MasterPure Complete DNA and RNA Purification Kit,92,140,kit	"[{""token"": ""MasterPure Complete DNA and RNA Purification Kit"", ""start_span"": 92, ""end_span"": 140, ""type"": ""kit""}]"	train
mongolica PTPinus tabuliformis Soil DNA Extraction and 16S rDNA Sequencing DNA was extracted from 0. 5 g of soil using the FastDNA SPIN Kit for Soil ( MP Biomedicals, Santa Ana, CA, USA), following the manufacturers instructions.	FastDNA SPIN Kit,123,139,kit	"[{""token"": ""FastDNA SPIN Kit"", ""start_span"": 123, ""end_span"": 139, ""type"": ""kit""}]"	train
Analysis of Bacterial Community Composition DNA / RNA was extracted from the sediment samples using a DNA / RNA mini kit ( Qiagen; Hilden, Germany) and physically separated in RNA and DNA.	DNA / RNA mini kit,102,120,kit	"[{""token"": ""DNA / RNA mini kit"", ""start_span"": 102, ""end_span"": 120, ""type"": ""kit""}]"	train
Genomic DNA was extracted from the same initial samples with the RNA PowerSoil DNA Elution Accessory Kit ( MO BIO laboratories, Carlsbad, CA, USA).	RNA PowerSoil DNA Elution Accessory Kit,65,104,kit	"[{""token"": ""RNA PowerSoil DNA Elution Accessory Kit"", ""start_span"": 65, ""end_span"": 104, ""type"": ""kit""}]"	train
Community RNA was extracted from both planktonic and attached cells according to the manufacturers instruction using the RNeasy midi kit for isolation of total RNA from Bacteria ( Qiagen, Germany).	RNeasy midi kit,121,136,kit	"[{""token"": ""RNeasy midi kit"", ""start_span"": 121, ""end_span"": 136, ""type"": ""kit""}]"	train
DNA was extracted using the DNeasy Plant MiniKit ( Qiagen), with a modified protocol to include a freeze - fracture step and Proteinase K treatment.	DNeasy Plant MiniKit,28,48,kit	"[{""token"": ""DNeasy Plant MiniKit"", ""start_span"": 28, ""end_span"": 48, ""type"": ""kit""}]"	train
Microbial inventories and data analysis Total DNA was extracted from samples ( ~ 0. 25g of material) using the MoBio PowerFecal DNA isolation kit, which includes vortexing with garnet beads to facilitate cell lysis.	MoBio PowerFecal DNA isolation kit,111,145,kit	"[{""token"": ""MoBio PowerFecal DNA isolation kit"", ""start_span"": 111, ""end_span"": 145, ""type"": ""kit""}]"	train
Following homogenisation, the DNA was extracted using a QIAamp DNA Stool Mini Kit according to the manufacturers instructions ( Qiagen).	QIAamp DNA Stool Mini Kit,56,81,kit	"[{""token"": ""QIAamp DNA Stool Mini Kit"", ""start_span"": 56, ""end_span"": 81, ""type"": ""kit""}]"	train
DNA Recovery and Quantitative PCR The samples were washed thrice with phosphate buffer ( pH7. 4) and subjected to DNA recovery with a MoBio PowerSoil DNA isolation kit ( Carlsbad, CA).	MoBio PowerSoil DNA isolation kit,134,167,kit	"[{""token"": ""MoBio PowerSoil DNA isolation kit"", ""start_span"": 134, ""end_span"": 167, ""type"": ""kit""}]"	train
DNA Extraction, Sequencing Strategy DNA from biomass - containing filters and sediment samples were extracted with modified methods by using MP Biomedical Fast DNA Spin kits ( Hou et al., 2013).	MP Biomedical Fast DNA Spin kits,141,173,kit	"[{""token"": ""MP Biomedical Fast DNA Spin kits"", ""start_span"": 141, ""end_span"": 173, ""type"": ""kit""}]"	train
DNA in bare surface soil samples were extracted via the PowerSoil DNA Isolation kit ( Mo Bio Laboratories) following manufacturers protocol.	PowerSoil DNA Isolation kit,56,83,kit	"[{""token"": ""PowerSoil DNA Isolation kit"", ""start_span"": 56, ""end_span"": 83, ""type"": ""kit""}]"	train
DNA extractions were performed using a PowerMag microbiome RNA / DNA isolation kit ( Mo Bio Laboratories, Inc., Carlsbad, CA), and the reaction mixtures were processed using a Hamilton Microlab Star robotic platform ( Hamilton, Reno, NV).	PowerMag microbiome RNA / DNA isolation kit,39,82,kit	"[{""token"": ""PowerMag microbiome RNA / DNA isolation kit"", ""start_span"": 39, ""end_span"": 82, ""type"": ""kit""}]"	train
Total DNA was isolated with the commercial FastDNA SPIN kit for soil ( MP Biomedicals, Solon, OH) and submitted to cloning and sequencing, following the procedure described for oleate enrichment cultures but using the primer set Bac27f / Uni1492r ( 44) to amplify 16S rRNA genes.	FastDNA SPIN kit,43,59,kit	"[{""token"": ""FastDNA SPIN kit"", ""start_span"": 43, ""end_span"": 59, ""type"": ""kit""}]"	train
Genomic DNA was extracted using DNeasy ( Qiagen) and subjected to 16S rRNA amplifications similar to59.	DNeasy,32,38,kit	"[{""token"": ""DNeasy"", ""start_span"": 32, ""end_span"": 38, ""type"": ""kit""}]"	train
Gut microbiota analysis DNA isolation: DNA was extracted from the swabs with a MoBio Power soil DNA isolation kit ( MoBio Laboratories, USA) following the manufacturers instructions.	MoBio Power soil DNA isolation kit,79,113,kit	"[{""token"": ""MoBio Power soil DNA isolation kit"", ""start_span"": 79, ""end_span"": 113, ""type"": ""kit""}]"	train
DNA extraction DNA was extracted from 125 mg of fresh fecal samples using the AllPrep Bacterial kit ( Mo Bio 47054; Mo Bio Laboratories, Carlsbad, CA, USA) as per the manufacturers protocol.	AllPrep Bacterial kit,78,99,kit	"[{""token"": ""AllPrep Bacterial kit"", ""start_span"": 78, ""end_span"": 99, ""type"": ""kit""}]"	train
Following established methods reviewed by Wu et al. [ 30], we used the Zymo DNA extraction kit ( Zymo Research) to extract microbial DNA from thawed samples and quantified the DNA using OD260 / 280 nanodrop.	Zymo DNA extraction kit,71,94,kit	"[{""token"": ""Zymo DNA extraction kit"", ""start_span"": 71, ""end_span"": 94, ""type"": ""kit""}]"	train
RNA extraction and quantitative real - time PCR Total RNA was isolated using the RNeasy Mini Kit ( Qiagen, Hilden, Germany) following the manufacturers recommendations.	RNeasy Mini Kit,81,96,kit	"[{""token"": ""RNeasy Mini Kit"", ""start_span"": 81, ""end_span"": 96, ""type"": ""kit""}]"	train
These pools were centrifuged, and the DNA was extracted with DNeasy PowerSoil Kit ( Qiagen, Hilden, Germany).	DNeasy PowerSoil Kit,61,81,kit	"[{""token"": ""DNeasy PowerSoil Kit"", ""start_span"": 61, ""end_span"": 81, ""type"": ""kit""}]"	train
DNA was extracted using the FastDNA spin kit for soil ( MP Biomedicals).	FastDNA spin kit for soil,28,53,kit	"[{""token"": ""FastDNA spin kit for soil"", ""start_span"": 28, ""end_span"": 53, ""type"": ""kit""}]"	train
RNA isolation and genome wide mRNA expression analysis Total RNA was isolated with the Qiacube system using the RNeasy Mini Kit with DNase digestion ( Qiagen, Hilden, Germany) to eliminate genomic DNA.	RNeasy Mini Kit,112,127,kit	"[{""token"": ""RNeasy Mini Kit"", ""start_span"": 112, ""end_span"": 127, ""type"": ""kit""}]"	train
The DNA was extracted using the MagMidi kit ( LGC Genomics, UK) for the KingFisher Flex robot ( ThermoFisher Scientific, Wilmington, USA) according to the manufacturers protocol, and its concentration was measured by Qubit fluorometer with Quant - iT dsDNA Br assay kit ( Invitrogen, USA).	MagMidi kit,32,43,kit	"[{""token"": ""MagMidi kit"", ""start_span"": 32, ""end_span"": 43, ""type"": ""kit""}]"	train
DNA extraction from these samples was performed using the FastDNA SPIN kit for soil ( MP Biomedicals, Solon, OH) according to the manufacturer ' s protocol.	FastDNA SPIN kit,58,74,kit	"[{""token"": ""FastDNA SPIN kit"", ""start_span"": 58, ""end_span"": 74, ""type"": ""kit""}]"	train
The metagenomic DNA in 0. 2g of each fecal sample was extracted by the QIAamp DNA stool minikit ( Qiagen, Germany).	QIAamp DNA stool minikit,71,95,kit	"[{""token"": ""QIAamp DNA stool minikit"", ""start_span"": 71, ""end_span"": 95, ""type"": ""kit""}]"	train
DNA extraction and HiSeq sequencing Genomic DNA was extracted from 0. 5g of soil using a FastDNA SPIN Kit for soil ( MP Biomedicals) and stored at 40C.	FastDNA SPIN Kit,89,105,kit	"[{""token"": ""FastDNA SPIN Kit"", ""start_span"": 89, ""end_span"": 105, ""type"": ""kit""}]"	train
DNA was extracted using a PowerSoil DNA Isolation Kit ( MoBio Laboratories, Carlsbad, CA; Cat # 12888 - 100) according to the manufacturers protocol with one modification.	PowerSoil DNA Isolation Kit,26,53,kit	"[{""token"": ""PowerSoil DNA Isolation Kit"", ""start_span"": 26, ""end_span"": 53, ""type"": ""kit""}]"	train
RNA was further purified with an RNEasy minikit ( Qiagen, Hilden, Germany) and on - column DNase 1 ( Qiagen, Hilden, Germany) treatment.	RNEasy minikit,33,47,kit	"[{""token"": ""RNEasy minikit"", ""start_span"": 33, ""end_span"": 47, ""type"": ""kit""}]"	train
16S rRNA Gene and Metagenome Pyrosequencing Genomic DNA was extracted from the granules using the Power Soil DNA isolation kit ( MoBio, Inc.); see SI.	Power Soil DNA isolation kit,98,126,kit	"[{""token"": ""Power Soil DNA isolation kit"", ""start_span"": 98, ""end_span"": 126, ""type"": ""kit""}]"	train
Entire buccal swabs and 500 l saliva samples were extracted using the PowerMicrobiome RNA isolation kit ( Mo Bio 26000 - 50; Mo Bio Laboratories, Carlsbad, CA, USA) as per the manufacturers protocol, omitting the necessary steps for co - elution of DNA and RNA, and with elution of nucleic acids in 50 l. 16S rRNA gene sequencing The bacterial 16S rRNA gene V4 region was amplified by PCR using barcoded Illumina adapter - containing primers 515F and 806R ( Caporaso et al., 2012) and sequenced with the 2 250 bp cartridges in the MiSeq platform ( Illumina, San Diego, USA).	PowerMicrobiome RNA isolation kit,70,103,kit	"[{""token"": ""PowerMicrobiome RNA isolation kit"", ""start_span"": 70, ""end_span"": 103, ""type"": ""kit""}]"	train
Total RNA was extracted from particles retained by the filters using bead beating and RNEasy Mini Kits ( Gifford et al., 2011;	RNEasy Mini Kits,86,102,kit	"[{""token"": ""RNEasy Mini Kits"", ""start_span"": 86, ""end_span"": 102, ""type"": ""kit""}]"	train
16S rRNA sequencing and data processing The metagenomic DNA was extracted from the cecal contents using AccuVisBio DNA stool extraction kit ( AccuVisBio, Abu Dhabi) according to the manufacturers instructions, and the DNA concentration was measured by using the Qubit system ( Invitrogen, USA).	AccuVisBio DNA stool extraction kit,104,139,kit	"[{""token"": ""AccuVisBio DNA stool extraction kit"", ""start_span"": 104, ""end_span"": 139, ""type"": ""kit""}]"	train
DNA Sequencing and Bioinformatics DNA was extracted from the cryoconite hole sediments and soils using the PowerSoil DNA Isolation kit ( MoBio Laboratories).	PowerSoil DNA Isolation kit,107,134,kit	"[{""token"": ""PowerSoil DNA Isolation kit"", ""start_span"": 107, ""end_span"": 134, ""type"": ""kit""}]"	train
DNA isolation was performed using the PowerLyzer PowerSoil Kit ( MO BIO Laboratories, Carlsbad, CA USA) using 0. 25g faeces or luminal content according to the manufacturers protocol.	PowerLyzer PowerSoil Kit,38,62,kit	"[{""token"": ""PowerLyzer PowerSoil Kit"", ""start_span"": 38, ""end_span"": 62, ""type"": ""kit""}]"	train
not calculated, due to low number of samplesaConcentrations and cell counts have been averaged over the top 10cm of sediment, and rates have been integrated over the top 10cm of sediment using samples of respective zones from six expeditions: LAtalante ( 2001), PS64 ( 2003), VKGD276 ( 2006), PS70 ( 2007), PS74 ( 2009), MSM16 ( 2010) bCell counts are given as cells 108ml1 sediment 16S rRNA gene V4 - V6 amplicon pyrosequencing DNA extraction was done in duplicates using 1g sediment each and a commercially available extraction kit ( UltraClean Soil DNA Isolation Kit, MoBio, Carlsbad, CA).	UltraClean Soil DNA Isolation Kit,536,569,kit	"[{""token"": ""UltraClean Soil DNA Isolation Kit"", ""start_span"": 536, ""end_span"": 569, ""type"": ""kit""}]"	train
DNA Extraction, Amplification and 454 Pyrosequencing of 16S rRNA Gene Amplicons Genomic DNA was extracted from known amounts of the granular sludge before ( i. e., inoculum granules) and after incubation with selenite ( i. e., selenite reducing granules) using the Power Soil DNA isolation kit ( MoBio, Inc.) as described in detail previously ( Gonzalez - Gil et al., 2015).	Power Soil DNA isolation kit,265,293,kit	"[{""token"": ""Power Soil DNA isolation kit"", ""start_span"": 265, ""end_span"": 293, ""type"": ""kit""}]"	train
Total RNA was extracted with the RNA PowerSoil Kit ( MO BIO laboratories, Carlsbad, CA, USA).	RNA PowerSoil Kit,33,50,kit	"[{""token"": ""RNA PowerSoil Kit"", ""start_span"": 33, ""end_span"": 50, ""type"": ""kit""}]"	train
18 g of total extracted RNA were treated with DNase and Riboblock RNase inhibitor ( Fermentas, Thermo Fisher Scientific GmbH, Germany) and purified with Qiagen RNeasy MiniElute Cleanup kit ( Qiagen GmbH, Germany).	Qiagen RNeasy MiniElute Cleanup kit,153,188,kit	"[{""token"": ""Qiagen RNeasy MiniElute Cleanup kit"", ""start_span"": 153, ""end_span"": 188, ""type"": ""kit""}]"	train
