Sentence	entity_1	json	split
The activity of the transcription factor NF - kappaB is thought to be regulated mainly through cytoplasmic retention by IkappaB molecules.	cytoplasmic,95,106,Cellular_component	"[{""token"": ""cytoplasmic"", ""start_span"": 95, ""end_span"": 106, ""type"": ""Cellular_component""}]"	train
Overexpressed TRAF2 or TRAF6 activate JNK, p38, or IKK in the absence of extracellular stimulation.	extracellular,73,86,Cellular_component	"[{""token"": ""extracellular"", ""start_span"": 73, ""end_span"": 86, ""type"": ""Cellular_component""}]"	train
Like LPS, sPGN and LTA bind to the glycosylphosphatidylinositol - anchored membrane protein CD14 and induce activation of the transcription factor NF - kappaB in host cells like macrophages.	membrane,75,83,Cellular_component	"[{""token"": ""membrane"", ""start_span"": 75, ""end_span"": 83, ""type"": ""Cellular_component""}]"	train
Coexpression together with membrane CD14 enhances sPGN signal transmission through TLR2.	membrane,27,35,Cellular_component	"[{""token"": ""membrane"", ""start_span"": 27, ""end_span"": 35, ""type"": ""Cellular_component""}]"	train
Glycoprotein reglucosylation and nucleotide sugar utilization in the secretory pathway: identification of a nucleoside diphosphatase in the endoplasmic reticulum.	endoplasmic reticulum,140,161,Cellular_component	"[{""token"": ""endoplasmic reticulum"", ""start_span"": 140, ""end_span"": 161, ""type"": ""Cellular_component""}]"	train
We describe here the identification, purification and characterization of an ER enzyme that hydrolyzes UDP to UMP.	ER,77,79,Cellular_component	"[{""token"": ""ER"", ""start_span"": 77, ""end_span"": 79, ""type"": ""Cellular_component""}]"	train
This nucleoside diphosphatase is a ubiquitously expressed, soluble 45 kDa glycoprotein devoid of transmembrane domains and KDEL - related ER localization sequences.	ER,138,140,Cellular_component	"[{""token"": ""ER"", ""start_span"": 138, ""end_span"": 140, ""type"": ""Cellular_component""}]"	train
By eliminating UDP, which is an inhibitory product of the UDP - Glc: glycoprotein glucosyltransferase, it is likely to promote reglucosylation reactions involved in glycoprotein folding and quality control in the ER.	ER,213,215,Cellular_component	"[{""token"": ""ER"", ""start_span"": 213, ""end_span"": 215, ""type"": ""Cellular_component""}]"	train
Overproduction of human Myt1 kinase induces a G2 cell cycle delay by interfering with the intracellular trafficking of Cdc2 - cyclin B1 complexes.	intracellular,90,103,Cellular_component	"[{""token"": ""intracellular"", ""start_span"": 90, ""end_span"": 103, ""type"": ""Cellular_component""}]"	train
These results suggest that the docking of Cdc2 - cyclin B1 complexes to the COOH terminus of Myt1 facilitates the phosphorylation of Cdc2 by Myt1 and that overproduction of Myt1 perturbs cell cycle progression by sequestering Cdc2 - cyclin B1 complexes in the cytoplasm.	cytoplasm,260,269,Cellular_component	"[{""token"": ""cytoplasm"", ""start_span"": 260, ""end_span"": 269, ""type"": ""Cellular_component""}]"	train
We show that A20 does not inhibit TNF - induced nuclear translocation and DNA binding of NF - kappaB, although it completely prevents the TNF - induced activation of an NF - kappaB - dependent reporter gene, as well as TNF - induced IL - 6 and granulocyte macrophage - colony stimulating factor gene expression.	nuclear,48,55,Cellular_component	"[{""token"": ""nuclear"", ""start_span"": 48, ""end_span"": 55, ""type"": ""Cellular_component""}]"	train
Wnt stabilizes cytosolic beta - catenin, which then binds to TCF and activates gene transcription.	cytosolic,15,24,Cellular_component	"[{""token"": ""cytosolic"", ""start_span"": 15, ""end_span"": 24, ""type"": ""Cellular_component""}]"	train
We report the purification and characterization of a native multisubunit complex ( NuA4) from yeast that acetylates nucleosomal histone H4.	nucleosomal,116,127,Cellular_component	"[{""token"": ""nucleosomal"", ""start_span"": 116, ""end_span"": 127, ""type"": ""Cellular_component""}]"	train
Finally, the ability of NuA4 to stimulate GAL4 - VP16 - driven transcription from chromatin templates in vitro is also lost in the temperature - sensitive esa1 mutant.	chromatin,82,91,Cellular_component	"[{""token"": ""chromatin"", ""start_span"": 82, ""end_span"": 91, ""type"": ""Cellular_component""}]"	train
The function of the essential Esa1 protein as the HAT subunit of NuA4 and the presence of Tra1p, a putative transcription activator - interacting subunit, supports an essential link between nuclear H4 acetylation, transcriptional regulation and cell cycle control.	nuclear,190,197,Cellular_component	"[{""token"": ""nuclear"", ""start_span"": 190, ""end_span"": 197, ""type"": ""Cellular_component""}]"	train
Two co - existing mechanisms for nuclear import of MAP kinase: passive diffusion of a monomer and active transport of a dimer.	nuclear,33,40,Cellular_component	"[{""token"": ""nuclear"", ""start_span"": 33, ""end_span"": 40, ""type"": ""Cellular_component""}]"	train
Here we show evidence that tyrosine ( Tyr190 in Xenopus MPK1 / ERK2) phosphorylation of MAPK by MAPKK is necessary and sufficient for the dissociation of the MAPKK - MAPK complex, and that the dissociation of the complex is required for the nuclear translocation of MAPK.	nuclear,241,248,Cellular_component	"[{""token"": ""nuclear"", ""start_span"": 241, ""end_span"": 248, ""type"": ""Cellular_component""}]"	train
These results suggest that monomeric and dimeric forms of MAPK enter the nucleus by passive diffusion and active transport mechanisms, respectively.	nucleus,73,80,Cellular_component	"[{""token"": ""nucleus"", ""start_span"": 73, ""end_span"": 80, ""type"": ""Cellular_component""}]"	train
Regulated nuclear localisation of the yeast transcription factor Ace2p controls expression of chitinase ( CTS1) in Saccharomyces cerevisiae.	nuclear,10,17,Cellular_component	"[{""token"": ""nuclear"", ""start_span"": 10, ""end_span"": 17, ""type"": ""Cellular_component""}]"	train
Nuclear localisation of Ace2p is restricted to late M and early G phases of the mitotic cell cycle.	Nuclear,0,7,Cellular_component	"[{""token"": ""Nuclear"", ""start_span"": 0, ""end_span"": 7, ""type"": ""Cellular_component""}]"	train
We show here that this nuclear localisation is directly associated with regulation of CTS1 expression.	nuclear,23,30,Cellular_component	"[{""token"": ""nuclear"", ""start_span"": 23, ""end_span"": 30, ""type"": ""Cellular_component""}]"	train
Using a version of Ace2p tagged with a c - myc epitope, we show that the protein is excluded from the nucleus of cells during most phases of the mitotic cell cycle.	nucleus,102,109,Cellular_component	"[{""token"": ""nucleus"", ""start_span"": 102, ""end_span"": 109, ""type"": ""Cellular_component""}]"	train
A mutant derivative in which one threonine and two serine residues, which are candidate phosphorylation sites, were replaced by alanine ( to mimic constitutive dephosphorylation) is localised in the nucleus throughout the cell cycle.	nucleus,199,206,Cellular_component	"[{""token"": ""nucleus"", ""start_span"": 199, ""end_span"": 206, ""type"": ""Cellular_component""}]"	train
Ace2p is therefore controlled throughout the cell cycle at three levels: transcription, nuclear localisation, and proteolysis.	nuclear,88,95,Cellular_component	"[{""token"": ""nuclear"", ""start_span"": 88, ""end_span"": 95, ""type"": ""Cellular_component""}]"	train
In its inactive state, NF - kappaB is constitutively present in the cytoplasm as a p50 - p65 heterodimer bound to its inhibitory protein IkappaB.	cytoplasm,68,77,Cellular_component	"[{""token"": ""cytoplasm"", ""start_span"": 68, ""end_span"": 77, ""type"": ""Cellular_component""}]"	train
Proinflammatory cytokines, such as tumor necrosis factor ( TNF), activate NF - kappaB by stimulating the activity of the IkappaB kinases ( IKKs) which phosphorylate IkappaBalpha on serine residues 32 and 36, targeting it for rapid degradation by the 26 S proteasome.	26 S proteasome,250,265,Cellular_component	"[{""token"": ""26 S proteasome"", ""start_span"": 250, ""end_span"": 265, ""type"": ""Cellular_component""}]"	train
This enables the release and nuclear translocation of the NF - kappaB complex and activation of gene transcription.	nuclear,29,36,Cellular_component	"[{""token"": ""nuclear"", ""start_span"": 29, ""end_span"": 36, ""type"": ""Cellular_component""}]"	train
We cloned a mouse phosphatidylinositol glycan - class N ( Pig - n) gene that encodes a 931amino acid protein expressed in the endoplasmic reticulum, which is homologous to yeast Mcd4p.	endoplasmic reticulum,126,147,Cellular_component	"[{""token"": ""endoplasmic reticulum"", ""start_span"": 126, ""end_span"": 147, ""type"": ""Cellular_component""}]"	train
The surface expression of Thy - 1 was only partially affected, indicating that modification of the first mannose by phosphoethanolamine is not essential for attachment of GPI anchors in mammalian cells.	surface,4,11,Cellular_component	"[{""token"": ""surface"", ""start_span"": 4, ""end_span"": 11, ""type"": ""Cellular_component""}]"	train
An inhibitor of GPI biosynthesis, YW3548 / BE49385A, inhibited transfer of phosphoethanolamine to the first mannose in mammalian cells but only slightly affected the surface expression of GPI - anchored proteins.	surface,166,173,Cellular_component	"[{""token"": ""surface"", ""start_span"": 166, ""end_span"": 173, ""type"": ""Cellular_component""}]"	train
The putative tumor suppressors EXT1 and EXT2 form a stable complex that accumulates in the Golgi apparatus and catalyzes the synthesis of heparan sulfate.	Golgi apparatus,91,106,Cellular_component	"[{""token"": ""Golgi apparatus"", ""start_span"": 91, ""end_span"": 106, ""type"": ""Cellular_component""}]"	train
The proteins encoded by these genes, EXT1 and EXT2, are endoplasmic reticulum - localized type II transmembrane glycoproteins that possess or are tightly associated with glycosyltransferase activities involved in the polymerization of heparan sulfate.	endoplasmic reticulum,56,77,Cellular_component	"[{""token"": ""endoplasmic reticulum"", ""start_span"": 56, ""end_span"": 77, ""type"": ""Cellular_component""}]"	train
Instead, it appears that EXT1 and EXT2 form a hetero - oligomeric complex in vivo that leads to the accumulation of both proteins in the Golgi apparatus.	Golgi apparatus,137,152,Cellular_component	"[{""token"": ""Golgi apparatus"", ""start_span"": 137, ""end_span"": 152, ""type"": ""Cellular_component""}]"	train
Remarkably, the Golgi - localized EXT1 / EXT2 complex possesses substantially higher glycosyltransferase activity than EXT1 or EXT2 alone, which suggests that the complex represents the biologically relevant form of the enzyme ( s).	Golgi,16,21,Cellular_component	"[{""token"": ""Golgi"", ""start_span"": 16, ""end_span"": 21, ""type"": ""Cellular_component""}]"	train
Nuclear sequestration of the exchange factor Cdc24 by Far1 regulates cell polarity during yeast mating.	Nuclear,0,7,Cellular_component	"[{""token"": ""Nuclear"", ""start_span"": 0, ""end_span"": 7, ""type"": ""Cellular_component""}]"	train
Cytoskeletal rearrangements during the cell cycle and in response to signals are regulated by small Rho - type GTPases, but it is not known how these GTPases are activated in a spatial and temporal manner.	Cytoskeletal,0,12,Cellular_component	"[{""token"": ""Cytoskeletal"", ""start_span"": 0, ""end_span"": 12, ""type"": ""Cellular_component""}]"	train
Here we show that Cdc24, the guanine - nucleotide exchange factor for the yeast GTPase Cdc42, is sequestered in the cell nucleus by Far1.	cell nucleus,116,128,Cellular_component	"[{""token"": ""cell nucleus"", ""start_span"": 116, ""end_span"": 128, ""type"": ""Cellular_component""}]"	train
At bud emergence, activation of the G1 cyclin - dependent kinase Cdc28 - Cln triggers degradation of Far1 and, as a result, relocation of Cdc24 to the cytoplasm.	cytoplasm,151,160,Cellular_component	"[{""token"": ""cytoplasm"", ""start_span"": 151, ""end_span"": 160, ""type"": ""Cellular_component""}]"	train
In contrast, in response to mating pheromones, the Far1 - Cdc24 complex is exported from the nucleus by Msn5.	nucleus,93,100,Cellular_component	"[{""token"": ""nucleus"", ""start_span"": 93, ""end_span"": 100, ""type"": ""Cellular_component""}]"	train
Either degradation of Far1 or its nuclear export by Msn5 was sufficient for cell growth, suggesting that the two mechanisms are redundant for cell viability.	nuclear,34,41,Cellular_component	"[{""token"": ""nuclear"", ""start_span"": 34, ""end_span"": 41, ""type"": ""Cellular_component""}]"	train
Taken together, our results indicate that Far1 functions as a nuclear anchor for Cdc24.	nuclear,62,69,Cellular_component	"[{""token"": ""nuclear"", ""start_span"": 62, ""end_span"": 69, ""type"": ""Cellular_component""}]"	train
Translocation of Akt / PKB to the nucleus of osteoblast - like MC3T3 - E1 cells exposed to proliferative growth factors.	nucleus,34,41,Cellular_component	"[{""token"": ""nucleus"", ""start_span"": 34, ""end_span"": 41, ""type"": ""Cellular_component""}]"	train
An active phosphatidylinositol 3 - kinase ( PI3K) has been shown in nuclei of different cell types.	nuclei,68,74,Cellular_component	"[{""token"": ""nuclei"", ""start_span"": 68, ""end_span"": 74, ""type"": ""Cellular_component""}]"	train
Nuclear PI3K translocation has been demonstrated to be related to an analogous translocation of a PtdIns ( 3, 4, 5) P ( 3) activated PKC, the zeta isozyme.	Nuclear,0,7,Cellular_component	"[{""token"": ""Nuclear"", ""start_span"": 0, ""end_span"": 7, ""type"": ""Cellular_component""}]"	train
We have examined the issue of whether or not in the osteoblast - like clonal cell line MC3T3 - E1 there may be observed an insulin - like growth factor - I - ( IGF - I) and platelet - derived growth factor - ( PDGF) dependent nuclear translocation of an active Akt / PKB.	nuclear,226,233,Cellular_component	"[{""token"": ""nuclear"", ""start_span"": 226, ""end_span"": 233, ""type"": ""Cellular_component""}]"	train
Western blot analysis showed a maximal nuclear translocation after 20 min of IGF - I stimulation or after 30 min of PDGF treatment.	nuclear,39,46,Cellular_component	"[{""token"": ""nuclear"", ""start_span"": 39, ""end_span"": 46, ""type"": ""Cellular_component""}]"	train
Both growth factors increased rapidly and transiently the enzyme activity of immunoprecipitable nuclear Akt / PKB on a similar time scale and after 60 min the values were slightly higher than the basal levels.	nuclear,96,103,Cellular_component	"[{""token"": ""nuclear"", ""start_span"": 96, ""end_span"": 103, ""type"": ""Cellular_component""}]"	train
These findings strongly suggest that the intranuclear translocation of Akt / PKB is an important step in signalling pathways that mediate cell proliferation.	intranuclear,41,53,Cellular_component	"[{""token"": ""intranuclear"", ""start_span"": 41, ""end_span"": 53, ""type"": ""Cellular_component""}]"	train
Characterization of a cDNA encoding a novel human Golgi alpha 1, 2 - mannosidase ( IC) involved in N - glycan biosynthesis.	Golgi,50,55,Cellular_component	"[{""token"": ""Golgi"", ""start_span"": 50, ""end_span"": 55, ""type"": ""Cellular_component""}]"	train
A human cDNA encoding a 70. 9 - kDa type II membrane protein with sequence similarity to class I alpha1, 2 - mannosidases was isolated.	membrane,44,52,Cellular_component	"[{""token"": ""membrane"", ""start_span"": 44, ""end_span"": 52, ""type"": ""Cellular_component""}]"	train
This residue is the mannose cleaved from Man ( 9) GlcNAc ( 2) by the endoplasmic reticulum alpha1, 2 - mannosidase I to form Man ( 8) GlcNAc ( 2) isomer B.	endoplasmic reticulum,69,90,Cellular_component	"[{""token"": ""endoplasmic reticulum"", ""start_span"": 69, ""end_span"": 90, ""type"": ""Cellular_component""}]"	train
The order of mannose hydrolysis from either pyridylaminated Man ( 9) GlcNAc ( 2) or Man ( 8) GlcNAc ( 2) isomer B differs from that previously reported for mammalian Golgi alpha1, 2 - mannosidases IA and IB.	Golgi,166,171,Cellular_component	"[{""token"": ""Golgi"", ""start_span"": 166, ""end_span"": 171, ""type"": ""Cellular_component""}]"	train
The full - length alpha1, 2 - mannosidase IC was localized to the Golgi of MDBK and MDCK cells by indirect immunofluorescence.	Golgi,66,71,Cellular_component	"[{""token"": ""Golgi"", ""start_span"": 66, ""end_span"": 71, ""type"": ""Cellular_component""}]"	train
The expression pattern is different from that of human Golgi alpha1, 2 - mannosidases IA and IB.	Golgi,55,60,Cellular_component	"[{""token"": ""Golgi"", ""start_span"": 55, ""end_span"": 60, ""type"": ""Cellular_component""}]"	train
Therefore, the human genome contains at least three differentially regulated Golgi alpha1, 2 - mannosidase genes encoding enzymes with similar, but not identical specificities.	Golgi,77,82,Cellular_component	"[{""token"": ""Golgi"", ""start_span"": 77, ""end_span"": 82, ""type"": ""Cellular_component""}]"	train
In non - stimulated cells NF kappa B is anchored in the cytoplasm via the inhibitory protein I kappa B alpha.	cytoplasm,56,65,Cellular_component	"[{""token"": ""cytoplasm"", ""start_span"": 56, ""end_span"": 65, ""type"": ""Cellular_component""}]"	train
Polyubiquitination of proteins by Cdc34 / SCF complexes targets them for degradation by the 26S proteasome.	26S proteasome,92,106,Cellular_component	"[{""token"": ""26S proteasome"", ""start_span"": 92, ""end_span"": 106, ""type"": ""Cellular_component""}]"	train
Nud1p links astral microtubule organization and the control of exit from mitosis.	astral microtubule,12,30,Cellular_component	"[{""token"": ""astral microtubule"", ""start_span"": 12, ""end_span"": 30, ""type"": ""Cellular_component""}]"	train
Here, we describe that the core SPB component Nud1p is a key protein that functions in both processes.	SPB,32,35,Cellular_component	"[{""token"": ""SPB"", ""start_span"": 32, ""end_span"": 35, ""type"": ""Cellular_component""}]"	train
The astral microtubule organizing function of Nud1p is mediated by its interaction with the gamma - tubulin complex binding protein Spc72p.	astral microtubule,4,22,Cellular_component	"[{""token"": ""astral microtubule"", ""start_span"": 4, ""end_span"": 22, ""type"": ""Cellular_component""}]"	train
In conditional lethal nud1 - 2 cells, the MEN component Tem1p, a GTPase, is mislocalized, whereas the kinase Cdc15p is still associated with the SPB.	SPB,145,148,Cellular_component	"[{""token"": ""SPB"", ""start_span"": 145, ""end_span"": 148, ""type"": ""Cellular_component""}]"	train
Thus, in nud1 - 2 cells the failure of Tem1p to interact with Cdc15p at the SPB probably prevents mitotic exit.	SPB,76,79,Cellular_component	"[{""token"": ""SPB"", ""start_span"": 76, ""end_span"": 79, ""type"": ""Cellular_component""}]"	train
Mammalian Toll - like receptors ( TLRs) are expressed on innate immune cells and respond to the membrane components of Gram - positive or Gram - negative bacteria.	membrane components,96,115,Cellular_component	"[{""token"": ""membrane components"", ""start_span"": 96, ""end_span"": 115, ""type"": ""Cellular_component""}]"	train
However, the intracellular signaling events following TLR activation are largely unknown.	intracellular,13,26,Cellular_component	"[{""token"": ""intracellular"", ""start_span"": 13, ""end_span"": 26, ""type"": ""Cellular_component""}]"	train
S. aureus stimulation causes the recruitment of active Rac1 and phosphatidylinositol - 3 kinase ( PI3K) to the TLR2 cytosolic domain.	cytosolic,116,125,Cellular_component	"[{""token"": ""cytosolic"", ""start_span"": 116, ""end_span"": 125, ""type"": ""Cellular_component""}]"	train
A signaling cascade composed of Rac1, PI3K and Akt targets nuclear p65 transactivation independently of I kappa B alpha degradation.	nuclear,59,66,Cellular_component	"[{""token"": ""nuclear"", ""start_span"": 59, ""end_span"": 66, ""type"": ""Cellular_component""}]"	train
Yeast Mps1p phosphorylates the spindle pole component Spc110p in the N - terminal domain.	spindle pole,31,43,Cellular_component	"[{""token"": ""spindle pole"", ""start_span"": 31, ""end_span"": 43, ""type"": ""Cellular_component""}]"	train
This is the first time that phosphorylation sites of an SPB component have been determined, and these are the first sites of Mps1p phosphorylation identified.	SPB,56,59,Cellular_component	"[{""token"": ""SPB"", ""start_span"": 56, ""end_span"": 59, ""type"": ""Cellular_component""}]"	train
Localization of human Cdc25C is regulated both by nuclear export and 14 - 3 - 3 protein binding.	nuclear,50,57,Cellular_component	"[{""token"": ""nuclear"", ""start_span"": 50, ""end_span"": 57, ""type"": ""Cellular_component""}]"	train
Here we report that 14 - 3 - 3 binding regulates the intracellular trafficking of Cdc25C.	intracellular,53,66,Cellular_component	"[{""token"": ""intracellular"", ""start_span"": 53, ""end_span"": 66, ""type"": ""Cellular_component""}]"	train
A nuclear export signal ( NES) was identified within the amino terminus of Cdc25C.	nuclear,2,9,Cellular_component	"[{""token"": ""nuclear"", ""start_span"": 2, ""end_span"": 9, ""type"": ""Cellular_component""}]"	train
Although mutation of the NES did not effect 14 - 3 - 3 binding, it did cause nuclear accumulation of Cdc25C.	nuclear,77,84,Cellular_component	"[{""token"": ""nuclear"", ""start_span"": 77, ""end_span"": 84, ""type"": ""Cellular_component""}]"	train
These results demonstrate that 14 - 3 - 3 binding is dispensable for the nuclear export of Cdc25C.	nuclear,73,80,Cellular_component	"[{""token"": ""nuclear"", ""start_span"": 73, ""end_span"": 80, ""type"": ""Cellular_component""}]"	train
However, complete nuclear accumulation of Cdc25C required loss of both NES function and 14 - 3 - 3 binding and this was accomplished both pharmacologically and by mutation.	nuclear,18,25,Cellular_component	"[{""token"": ""nuclear"", ""start_span"": 18, ""end_span"": 25, ""type"": ""Cellular_component""}]"	train
The Rb / chromatin connection and epigenetic control: opinion.	chromatin,9,18,Cellular_component	"[{""token"": ""chromatin"", ""start_span"": 9, ""end_span"": 18, ""type"": ""Cellular_component""}]"	train
Rb represses E2F mainly by recruiting chromatin remodeling factors ( histone deacetylases and SWI / SNF complexes), the DNA methyltransferase DNMT1, and a histone methyltransferase.	chromatin,38,47,Cellular_component	"[{""token"": ""chromatin"", ""start_span"": 38, ""end_span"": 47, ""type"": ""Cellular_component""}]"	train
A model in which Rb irreversibly represses E2F - regulated genes in differentiated cells by an epigenetic mechanism linked to heterochromatin, and involving histone H3 and promoter DNA methylation, is discussed.	heterochromatin,126,141,Cellular_component	"[{""token"": ""heterochromatin"", ""start_span"": 126, ""end_span"": 141, ""type"": ""Cellular_component""}]"	train
Finally, P6, a 16 - kDa lipoprotein highly conserved in the outer membrane of all NTHi and H. influenzae type b strains, appears to also activate NF - kappa B via similar signaling pathways.	outer membrane,60,74,Cellular_component	"[{""token"": ""outer membrane"", ""start_span"": 60, ""end_span"": 74, ""type"": ""Cellular_component""}]"	train
Based on the murine MACS1 sequence, we also identified the location and organization of the human MACS1 gene, showing that the human MACS1 and Sa genes are located in the opposite transcriptional direction within a 150 - kilobase region on chromosome 16p13. 1.	chromosome 16p13,240,256,Cellular_component	"[{""token"": ""chromosome 16p13"", ""start_span"": 240, ""end_span"": 256, ""type"": ""Cellular_component""}]"	train
The GPI transamidase mediates GPI anchoring in the endoplasmic reticulum, by replacing a protein ' s C - terminal GPI attachment signal peptide with a pre - assembled GPI.	endoplasmic reticulum,51,72,Cellular_component	"[{""token"": ""endoplasmic reticulum"", ""start_span"": 51, ""end_span"": 72, ""type"": ""Cellular_component""}]"	train
Phosphorylation of I kappa Bs - - the cytoplasmic inhibitors of the NF - kappa B transcription factors - - is the key event which triggers activation of the NF - kappa B cascade.	cytoplasmic,38,49,Cellular_component	"[{""token"": ""cytoplasmic"", ""start_span"": 38, ""end_span"": 49, ""type"": ""Cellular_component""}]"	train
The common core 1 O - glycan structure Galbeta1 - - > 3GalNAc - R is the precursor for many extended mucin - type O - glycan structures in animal cell surface and secreted glycoproteins.	cell surface,146,158,Cellular_component	"[{""token"": ""cell surface"", ""start_span"": 146, ""end_span"": 158, ""type"": ""Cellular_component""}]"	train
The core 1 beta3 - Gal - T predicts a 363 - amino acid type II transmembrane protein.	transmembrane,63,76,Cellular_component	"[{""token"": ""transmembrane"", ""start_span"": 63, ""end_span"": 76, ""type"": ""Cellular_component""}]"	train
In most instances, translation is regulated at the initiation phase, when a ribosome is recruited to the 5 ' end of an mRNA.	ribosome,76,84,Cellular_component	"[{""token"": ""ribosome"", ""start_span"": 76, ""end_span"": 84, ""type"": ""Cellular_component""}]"	train
Subsequent recruitment of several components, including the small ribosomal subunit, is thought to allow migration of initiation complexes and recognition of the initiation codon.	small ribosomal subunit,60,83,Cellular_component	"[{""token"": ""small ribosomal subunit"", ""start_span"": 60, ""end_span"": 83, ""type"": ""Cellular_component""}]"	train
Bub3 interaction with Mad2, Mad3 and Cdc20 is mediated by WD40 repeats and does not require intact kinetochores.	kinetochores,99,111,Cellular_component	"[{""token"": ""kinetochores"", ""start_span"": 99, ""end_span"": 111, ""type"": ""Cellular_component""}]"	train
We suggest that Bub3 could serve as a platform for interactions between kinetochore checkpoint proteins, and its association with Mad2, Mad3 and Cdc20 might be instrumental for checkpoint activation.	kinetochore,72,83,Cellular_component	"[{""token"": ""kinetochore"", ""start_span"": 72, ""end_span"": 83, ""type"": ""Cellular_component""}]"	train
Carnitine is indispensable for energy metabolism, since it enables activated fatty acids to enter the mitochondria, where they are broken down via beta - oxidation.	mitochondria,102,114,Cellular_component	"[{""token"": ""mitochondria"", ""start_span"": 102, ""end_span"": 114, ""type"": ""Cellular_component""}]"	train
Separase, polo kinase, the kinetochore protein Slk19, and Spo12 function in a network that controls Cdc14 localization during early anaphase.	kinetochore,27,38,Cellular_component	"[{""token"": ""kinetochore"", ""start_span"": 27, ""end_span"": 38, ""type"": ""Cellular_component""}]"	train
In budding yeast, the phosphatase Cdc14, a key regulator of exit from mitosis, is released from its inhibitor Cfi1 / Net1 in the nucleolus during anaphase.	nucleolus,129,138,Cellular_component	"[{""token"": ""nucleolus"", ""start_span"": 129, ""end_span"": 138, ""type"": ""Cellular_component""}]"	train
We have identified a regulatory network, the FEAR ( Cdc fourteen early anaphase release) network that promotes Cdc14 release from the nucleolus during early anaphase.	nucleolus,134,143,Cellular_component	"[{""token"": ""nucleolus"", ""start_span"": 134, ""end_span"": 143, ""type"": ""Cellular_component""}]"	train
The FEAR network is comprised of the polo kinase Cdc5, the separase Esp1, the kinetochore - associated protein Slk19, and Spo12.	kinetochore,78,89,Cellular_component	"[{""token"": ""kinetochore"", ""start_span"": 78, ""end_span"": 89, ""type"": ""Cellular_component""}]"	train
Novel signal transduction pathway utilized by extracellular HSP70: role of toll - like receptor ( TLR) 2 and TLR4.	extracellular,46,59,Cellular_component	"[{""token"": ""extracellular"", ""start_span"": 46, ""end_span"": 59, ""type"": ""Cellular_component""}]"	train
Set2 is a nucleosomal histone H3 - selective methyltransferase that mediates transcriptional repression.	nucleosomal,10,21,Cellular_component	"[{""token"": ""nucleosomal"", ""start_span"": 10, ""end_span"": 21, ""type"": ""Cellular_component""}]"	train
cPGES is cytoplasmic, apparently identical to the hsp90 chaperone, p23, and associates functionally with prostaglandin - endoperoxide H synthase - 1 ( PGHS - 1), the constitutive cyclooxygenase.	cytoplasmic,9,20,Cellular_component	"[{""token"": ""cytoplasmic"", ""start_span"": 9, ""end_span"": 20, ""type"": ""Cellular_component""}]"	train
Calcineurin - dependent regulation of Crz1p nuclear export requires Msn5p and a conserved calcineurin docking site.	nuclear,44,51,Cellular_component	"[{""token"": ""nuclear"", ""start_span"": 44, ""end_span"": 51, ""type"": ""Cellular_component""}]"	train
In this work, we show that calcineurin - dependent dephosphorylation of Crz1p also down - regulates its nuclear export.	nuclear,104,111,Cellular_component	"[{""token"": ""nuclear"", ""start_span"": 104, ""end_span"": 111, ""type"": ""Cellular_component""}]"	train
In addition, we define the Crz1p nuclear export signal ( NES) and show that it interacts with Msn5p in a phosphorylation - dependent manner.	nuclear,33,40,Cellular_component	"[{""token"": ""nuclear"", ""start_span"": 33, ""end_span"": 40, ""type"": ""Cellular_component""}]"	train
This indicates that calcineurin regulates Crz1p nuclear export by dephosphorylating and inactivating its NES.	nuclear,48,55,Cellular_component	"[{""token"": ""nuclear"", ""start_span"": 48, ""end_span"": 55, ""type"": ""Cellular_component""}]"	train
Finally, we define a motif in Crz1p, PIISIQ, similar to the PxIxIT docking site for calcineurin on the mammalian transcription factor NFAT, that mediates the in vivo interaction between calcineurin and Crz1p and is required for calcineurin - dependent regulation of Crz1p nuclear export and activity.	nuclear,272,279,Cellular_component	"[{""token"": ""nuclear"", ""start_span"": 272, ""end_span"": 279, ""type"": ""Cellular_component""}]"	train
Despite biochemical and genetic data suggesting that E2F and pRB ( pocket protein) families regulate transcription via chromatin - modifying factors, the precise mechanisms underlying gene regulation by these protein families have not yet been defined in a physiological setting.	chromatin,119,128,Cellular_component	"[{""token"": ""chromatin"", ""start_span"": 119, ""end_span"": 128, ""type"": ""Cellular_component""}]"	train
Taken together, these findings show that p130 escorts E2F4 into the nucleus and, together with corepressor complexes that contain mSin3B and / or HDAC1, directly represses transcription from target genes as cells withdraw from the cell cycle.	nucleus,68,75,Cellular_component	"[{""token"": ""nucleus"", ""start_span"": 68, ""end_span"": 75, ""type"": ""Cellular_component""}]"	train
Uridine, a pyrimidine nucleoside essential for the synthesis of RNA and bio - membranes, is a crucial element in the regulation of normal physiological processes as well as pathological states.	bio - membranes,72,87,Cellular_component	"[{""token"": ""bio - membranes"", ""start_span"": 72, ""end_span"": 87, ""type"": ""Cellular_component""}]"	train
Current studies establish that wortmannin actually inhibits the uptake and colocalization of CpG DNA with toll - like receptor ( TLR) - 9 in endocytic vesicles, thereby preventing CpG - induced activation of the NF - kappaB signaling cascade.	vesicles,151,159,Cellular_component	"[{""token"": ""vesicles"", ""start_span"": 151, ""end_span"": 159, ""type"": ""Cellular_component""}]"	train
Finally, using chromatin immunoprecipitation, we demonstrate direct p53 - dependent recruitment of TRRAP to the mdm2 promoter, followed by increased histone acetylation.	chromatin,15,24,Cellular_component	"[{""token"": ""chromatin"", ""start_span"": 15, ""end_span"": 24, ""type"": ""Cellular_component""}]"	train
CLIP - 170 is a phosphoprotein and phosphorylation is thought to regulate the binding of CLIP - 170 to MTs.	MTs,103,106,Cellular_component	"[{""token"": ""MTs"", ""start_span"": 103, ""end_span"": 106, ""type"": ""Cellular_component""}]"	train
In addition, rapamycin inhibited the ability of CLIP - 170 to bind to MTs.	MTs,70,73,Cellular_component	"[{""token"": ""MTs"", ""start_span"": 70, ""end_span"": 73, ""type"": ""Cellular_component""}]"	train
Our observations suggest that multiple CLIP - 170 kinases are involved in positive and negative control of CLIP - 170, and FRAP is a CLIP - 170 kinase positively regulating the MT - binding behavior of CLIP - 170.	MT,177,179,Cellular_component	"[{""token"": ""MT"", ""start_span"": 177, ""end_span"": 179, ""type"": ""Cellular_component""}]"	train
Regulation of the yeast Rlm1 transcription factor by the Mpk1 cell wall integrity MAP kinase.	cell wall,62,71,Cellular_component	"[{""token"": ""cell wall"", ""start_span"": 62, ""end_span"": 71, ""type"": ""Cellular_component""}]"	train
Signalling through Rlm1 regulates the expression of at least 25 genes, most of which have been implicated in cell wall biogenesis.	cell wall,109,118,Cellular_component	"[{""token"": ""cell wall"", ""start_span"": 109, ""end_span"": 118, ""type"": ""Cellular_component""}]"	train
We report here the transcriptional induction by agents of cell wall stress of a set of lacZ reporter plasmids derived from several Rlm1 - responsive genes.	cell wall,58,67,Cellular_component	"[{""token"": ""cell wall"", ""start_span"": 58, ""end_span"": 67, ""type"": ""Cellular_component""}]"	train
We also demonstrate that a MAP kinase docking site, shown recently to mediate activation of MEF2A and MEF2C, is conserved in Rlm1 and is required for its ability to mediate transcriptional activation in response to agents that induce cell wall stress.	cell wall,234,243,Cellular_component	"[{""token"": ""cell wall"", ""start_span"": 234, ""end_span"": 243, ""type"": ""Cellular_component""}]"	train
Immunofluorescent confocal microscopy showed that Pdcd4 colocalizes with eIF4A in the cytoplasm.	cytoplasm,86,95,Cellular_component	"[{""token"": ""cytoplasm"", ""start_span"": 86, ""end_span"": 95, ""type"": ""Cellular_component""}]"	train
In vivo translation assays showed that Pdcd4 inhibited cap - dependent but not internal ribosome entry site ( IRES) - dependent translation.	ribosome,88,96,Cellular_component	"[{""token"": ""ribosome"", ""start_span"": 88, ""end_span"": 96, ""type"": ""Cellular_component""}]"	train
Fourth, chromatin immunoprecipitation assays demonstrate that endogenous E2F1 is associated with the cyclin D3 promoter in vivo.	chromatin,8,17,Cellular_component	"[{""token"": ""chromatin"", ""start_span"": 8, ""end_span"": 17, ""type"": ""Cellular_component""}]"	train
In this study, the consequences of LPS - induced PI 3 - kinase activation on cytokine and chemokine expression and the intracellular mechanisms of inflammatory activation were examined in mouse macrophages.	intracellular,119,132,Cellular_component	"[{""token"": ""intracellular"", ""start_span"": 119, ""end_span"": 132, ""type"": ""Cellular_component""}]"	train
Inhibition of PI 3 - kinase decreased the LPS - induced transcriptional activity of NF - kappaB, but it had no effect on the nuclear DNA binding activity of NF - kappaB.	nuclear,125,132,Cellular_component	"[{""token"": ""nuclear"", ""start_span"": 125, ""end_span"": 132, ""type"": ""Cellular_component""}]"	train
These findings suggest that, while NF - kappaB nuclear localization and DNA binding are necessary, they are not sufficient for transcriptional activation of the IL - 1beta gene in the absence of PI 3 - kinase activity.	nuclear,47,54,Cellular_component	"[{""token"": ""nuclear"", ""start_span"": 47, ""end_span"": 54, ""type"": ""Cellular_component""}]"	train
The amount of RSK1S154A was significantly increased in the membrane fraction under basal conditions.	membrane,59,67,Cellular_component	"[{""token"": ""membrane"", ""start_span"": 59, ""end_span"": 67, ""type"": ""Cellular_component""}]"	train
Using FRAP, we show that septins are mobile within the ring at bud emergence and telophase and are immobile during S, G2, and M phases.	bud,63,66,Cellular_component	"[{""token"": ""bud"", ""start_span"": 63, ""end_span"": 66, ""type"": ""Cellular_component""}]"	train
MD - 2 is a secreted glycoprotein that binds to the extracellular domain of Toll - like receptor 4 ( TLR4) and is required for the activation of TLR4 by lipopolysaccharide ( LPS).	extracellular,52,65,Cellular_component	"[{""token"": ""extracellular"", ""start_span"": 52, ""end_span"": 65, ""type"": ""Cellular_component""}]"	train
Peroxisomal membrane monocarboxylate transporters: evidence for a redox shuttle system?	Peroxisomal membrane,0,20,Cellular_component	"[{""token"": ""Peroxisomal membrane"", ""start_span"": 0, ""end_span"": 20, ""type"": ""Cellular_component""}]"	train
One of the many functions of liver peroxisomes is the beta - oxidation of long - chain fatty acids.	peroxisomes,35,46,Cellular_component	"[{""token"": ""peroxisomes"", ""start_span"": 35, ""end_span"": 46, ""type"": ""Cellular_component""}]"	train
Peroxisomal beta - oxidation was greatly stimulated by the addition of pyruvate and this increase was partially inhibited by the addition of the MCT blocker alpha - cyano - 4 - hydroxycinnamate ( CINN).	Peroxisomal,0,11,Cellular_component	"[{""token"": ""Peroxisomal"", ""start_span"": 0, ""end_span"": 11, ""type"": ""Cellular_component""}]"	train
We also found that peroxisomes generated lactate in the presence of pyruvate.	peroxisomes,19,30,Cellular_component	"[{""token"": ""peroxisomes"", ""start_span"": 19, ""end_span"": 30, ""type"": ""Cellular_component""}]"	train
Together these data provide compelling that the Peroxisome Lactate Shuttle helps maintain organelle redox and the proper functioning of peroxisomal beta - oxidation.	peroxisomal,136,147,Cellular_component	"[{""token"": ""peroxisomal"", ""start_span"": 136, ""end_span"": 147, ""type"": ""Cellular_component""}]"	train
The mutually exclusive subcellular distribution of glucosidase II and endomannosidase are discussed in terms of their significance for quality control of protein folding and N - glycosylation.	subcellular,23,34,Cellular_component	"[{""token"": ""subcellular"", ""start_span"": 23, ""end_span"": 34, ""type"": ""Cellular_component""}]"	train
Herein we apply homology - search methods to identify novel sequences belonging to a second SSAT, SSAT - 2, with a chromosomal location at 17p13. 1, which is distinct from SSAT - 1 at Xp22.	chromosomal,115,126,Cellular_component	"[{""token"": ""chromosomal"", ""start_span"": 115, ""end_span"": 126, ""type"": ""Cellular_component""}]"	train
By contrast, transfected SSAT - 2 had no effect on intracellular polyamine or acetylated polyamine pools.	intracellular,51,64,Cellular_component	"[{""token"": ""intracellular"", ""start_span"": 51, ""end_span"": 64, ""type"": ""Cellular_component""}]"	train
The data suggest that, in intact cells, SSAT - 2 may be compartmentalized or it may be inefficient at low intracellular polyamine concentrations.	intracellular,106,119,Cellular_component	"[{""token"": ""intracellular"", ""start_span"": 106, ""end_span"": 119, ""type"": ""Cellular_component""}]"	train
Although poorly membrane permeable, prostaglandins are believed to exit cells by passive diffusion.	membrane,16,24,Cellular_component	"[{""token"": ""membrane"", ""start_span"": 16, ""end_span"": 24, ""type"": ""Cellular_component""}]"	train
We have investigated the interaction between prostaglandins and members of the ATP - binding cassette ( ABC) transporter ABCC [ multidrug resistance protein ( MRP)] family of membrane export pumps.	membrane,175,183,Cellular_component	"[{""token"": ""membrane"", ""start_span"": 175, ""end_span"": 183, ""type"": ""Cellular_component""}]"	train
In inside - out membrane vesicles derived from insect cells or HEK293 cells, MRP4 catalyzed the time - and ATP - dependent uptake of prostaglandin E1 ( PGE1) and PGE2.	membrane vesicles,16,33,Cellular_component	"[{""token"": ""membrane vesicles"", ""start_span"": 16, ""end_span"": 33, ""type"": ""Cellular_component""}]"	train
ICBP90 ( Inverted CCAAT box Binding Protein of 90 kDa) is a recently identified nuclear protein that binds to one of the inverted CCAAT boxes of the topoisomerase IIalpha ( TopoIIalpha) gene promoter.	nuclear,80,87,Cellular_component	"[{""token"": ""nuclear"", ""start_span"": 80, ""end_span"": 87, ""type"": ""Cellular_component""}]"	train
Here, we show that ICBP90 shares structural homology with several other proteins, including Np95, the human and mouse NIRF, suggesting the emergence of a new family of nuclear proteins.	nuclear,168,175,Cellular_component	"[{""token"": ""nuclear"", ""start_span"": 168, ""end_span"": 175, ""type"": ""Cellular_component""}]"	train
The human UPase - 2 gene was mapped to chromosome 2q24. 1 and the 2. 2 - kb mRNA was predominantly expressed in kidney.	chromosome,39,49,Cellular_component	"[{""token"": ""chromosome"", ""start_span"": 39, ""end_span"": 49, ""type"": ""Cellular_component""}]"	train
The defects in ATM - dependent activation of CHK2, S phase checkpoint control, IR - induced nuclear focus formation, and radiation sensitivity apparent in NBS cells were not corrected by expression of NBS1 mutants that lack an intact MRE11 binding domain, suggesting that formation of the NBS1 - MRE11 - RAD50 complex is required for the corresponding normal phenotypes.	nuclear focus,92,105,Cellular_component	"[{""token"": ""nuclear focus"", ""start_span"": 92, ""end_span"": 105, ""type"": ""Cellular_component""}]"	train
Expression of NBS1 proteins with mutated ATM - targeted phosphorylation sites ( serines 278 or 343) did not restore S phase checkpoint control but did restore the ability of IR to activate CHK2 and to induce nuclear focus formation and normalized the radiation sensitivity of NBS cells.	nuclear focus,208,221,Cellular_component	"[{""token"": ""nuclear focus"", ""start_span"": 208, ""end_span"": 221, ""type"": ""Cellular_component""}]"	train
Expression of NBS1 containing mutations in the forkhead - associated or BRCA1 COOH terminus domains did not correct the defects in radiation sensitivity or nuclear focus formation but did restore S phase checkpoint control in NBS cells.	nuclear focus,156,169,Cellular_component	"[{""token"": ""nuclear focus"", ""start_span"": 156, ""end_span"": 169, ""type"": ""Cellular_component""}]"	train
Together, these data demonstrate that multiple functional domains of NBS1 are required for ATM - dependent activation of CHK2, nuclear focus formation, S phase checkpoint control, and cell survival after exposure to IR.	nuclear focus,127,140,Cellular_component	"[{""token"": ""nuclear focus"", ""start_span"": 127, ""end_span"": 140, ""type"": ""Cellular_component""}]"	train
The Toll / interleukin 1 receptor ( TIR) domain is a region found in the cytoplasmic tails of members of the Toll - like receptor / interleukin - 1 receptor superfamily.	cytoplasmic,73,84,Cellular_component	"[{""token"": ""cytoplasmic"", ""start_span"": 73, ""end_span"": 84, ""type"": ""Cellular_component""}]"	train
Identification of complex formation between two intracellular tyrosine kinase substrates: human c - Rel and the p105 precursor of p50 NF - kappa B.	intracellular,48,61,Cellular_component	"[{""token"": ""intracellular"", ""start_span"": 48, ""end_span"": 61, ""type"": ""Cellular_component""}]"	train
Both proteins are inducible by phytohemagglutinin ( PHA) and phorbol 12 - myristate 13 - acetate ( PMA) and their subcellular distribution is affected by this induction.	subcellular,114,125,Cellular_component	"[{""token"": ""subcellular"", ""start_span"": 114, ""end_span"": 125, ""type"": ""Cellular_component""}]"	train
We demonstrate that the Rel immune complex contains a protein with a molecular weight in the 40 kDa range ( p40) which apparently is exclusively cytoplasmic.	cytoplasmic,145,156,Cellular_component	"[{""token"": ""cytoplasmic"", ""start_span"": 145, ""end_span"": 156, ""type"": ""Cellular_component""}]"	train
This finding indicates a role for both proteins in intracellular signal transduction pathways which are modulated by modification of their phosphorylation status.	intracellular,51,64,Cellular_component	"[{""token"": ""intracellular"", ""start_span"": 51, ""end_span"": 64, ""type"": ""Cellular_component""}]"	train
An MRP5 - specific polyclonal antibody detected a glycoprotein of approximately 190 kd in crude cell membrane fractions from these samples.	cell membrane,96,109,Cellular_component	"[{""token"": ""cell membrane"", ""start_span"": 96, ""end_span"": 109, ""type"": ""Cellular_component""}]"	train
Furthermore, we could detect MRP5 and ATP - dependent transport of [ ( 3) H] cGMP in sarcolemma vesicles of human heart.	vesicles,96,104,Cellular_component	"[{""token"": ""vesicles"", ""start_span"": 96, ""end_span"": 104, ""type"": ""Cellular_component""}]"	train
We then describe how the TOR pathway can modulate translation in yeast and in mammals, through the modulation of the phosphorylation of key translation components, and the regulation of the abundance of ribosomes and translation factors.	ribosomes,203,212,Cellular_component	"[{""token"": ""ribosomes"", ""start_span"": 203, ""end_span"": 212, ""type"": ""Cellular_component""}]"	train
Analysis of cells expressing the human TLR2 cDNA or its c - myc - tagged version indicated that sTLR2 resulted from the posttranslational modification of the TLR2 protein in an intracellular compartment.	intracellular compartment,177,202,Cellular_component	"[{""token"": ""intracellular compartment"", ""start_span"": 177, ""end_span"": 202, ""type"": ""Cellular_component""}]"	train
Moreover, an intracellular pool of sTLR2 is maintained.	intracellular,13,26,Cellular_component	"[{""token"": ""intracellular"", ""start_span"": 13, ""end_span"": 26, ""type"": ""Cellular_component""}]"	train
Its activation during anaphase is characterized by dissociation from its inhibitor Cfi1 / Net1 in the nucleolus and is controlled by two regulatory networks.	nucleolus,102,111,Cellular_component	"[{""token"": ""nucleolus"", ""start_span"": 102, ""end_span"": 111, ""type"": ""Cellular_component""}]"	train
Inactivation of FOB1 leads to premature release of Cdc14 from the nucleolus in metaphase - arrested cells.	nucleolus,66,75,Cellular_component	"[{""token"": ""nucleolus"", ""start_span"": 66, ""end_span"": 75, ""type"": ""Cellular_component""}]"	train
Conversely, high levels of FOB1 delay the release of Cdc14 from the nucleolus.	nucleolus,68,77,Cellular_component	"[{""token"": ""nucleolus"", ""start_span"": 68, ""end_span"": 77, ""type"": ""Cellular_component""}]"	train
Various chromatin regulatory complexes have been linked to Rb / E2F proteins, and changes in histone modifications correlate with states of E2F - dependent transcription.	chromatin,8,17,Cellular_component	"[{""token"": ""chromatin"", ""start_span"": 8, ""end_span"": 17, ""type"": ""Cellular_component""}]"	train
A20 is a cytoplasmic protein required for the termination of tumor necrosis factor ( TNF) - induced signals.	cytoplasmic,9,20,Cellular_component	"[{""token"": ""cytoplasmic"", ""start_span"": 9, ""end_span"": 20, ""type"": ""Cellular_component""}]"	train
Chromatin immunoprecipitation assays identify multiple interactions of E2F proteins that include those previously shown to activate and repress transcription.	Chromatin,0,9,Cellular_component	"[{""token"": ""Chromatin"", ""start_span"": 0, ""end_span"": 9, ""type"": ""Cellular_component""}]"	train
In contrast to the dramatic elevation of nuclear p50 / p65 heterodimers induced by tumor necrosis factor alpha, DNA binding of p50 / p50 homodimers was not greatly altered.	nuclear,41,48,Cellular_component	"[{""token"": ""nuclear"", ""start_span"": 41, ""end_span"": 48, ""type"": ""Cellular_component""}]"	train
Taken together, these findings reveal for the first time that there is a direct interaction between PKAc and p50 that accounts for constitutive phosphorylation of p50 Ser ( 337) and the existence of DNA bound p50 / p50 in the nuclei of most resting cells.	nuclei,226,232,Cellular_component	"[{""token"": ""nuclei"", ""start_span"": 226, ""end_span"": 232, ""type"": ""Cellular_component""}]"	train
This mechanism of DNA binding by p50 / p50 following phosphorylation of Ser ( 337) by PKAc may represent an important means for maintaining stable negative regulation of NF - kappaB gene expression in the absence of extracellular stimulation.	extracellular,216,229,Cellular_component	"[{""token"": ""extracellular"", ""start_span"": 216, ""end_span"": 229, ""type"": ""Cellular_component""}]"	train
Ran GTPase regulates Mad2 localization to the nuclear pore complex.	nuclear pore complex,46,66,Cellular_component	"[{""token"": ""nuclear pore complex"", ""start_span"": 46, ""end_span"": 66, ""type"": ""Cellular_component""}]"	train
We utilized cells with conditional mutations in the yeast Ran GTPase pathway to examine the relationship between Ran and targeting of checkpoint regulators to the NPC.	NPC,163,166,Cellular_component	"[{""token"": ""NPC"", ""start_span"": 163, ""end_span"": 166, ""type"": ""Cellular_component""}]"	train
The displacement of Mad2p in M - phase cells was correlated with activation of the spindle checkpoint.	spindle,83,90,Cellular_component	"[{""token"": ""spindle"", ""start_span"": 83, ""end_span"": 90, ""type"": ""Cellular_component""}]"	train
This is the first evidence indicating that Ran affects the localization of Mad2p to the NPC.	NPC,88,91,Cellular_component	"[{""token"": ""NPC"", ""start_span"": 88, ""end_span"": 91, ""type"": ""Cellular_component""}]"	train
The LRP5 is a co - receptor of Wnt located on the osteoblast membrane between two other receptors, Frizzled and Kremen.	membrane,61,69,Cellular_component	"[{""token"": ""membrane"", ""start_span"": 61, ""end_span"": 69, ""type"": ""Cellular_component""}]"	train
The small GTPase RhoA regulates a wide spectrum of cellular functions including transformation and cytoskeletal reorganization.	cytoskeletal,99,111,Cellular_component	"[{""token"": ""cytoskeletal"", ""start_span"": 99, ""end_span"": 111, ""type"": ""Cellular_component""}]"	train
These mutants were then used to investigate the role of PLD1 in the cytoskeletal reorganization stimulated by RhoA signaling.	cytoskeletal,68,80,Cellular_component	"[{""token"": ""cytoskeletal"", ""start_span"": 68, ""end_span"": 80, ""type"": ""Cellular_component""}]"	train
EMSAs indicated the specific binding of nuclear complexes to the E2F6 promoter that contained E2F1 - related species whose binding was specifically competed by the consensus E2F binding site.	nuclear,40,47,Cellular_component	"[{""token"": ""nuclear"", ""start_span"": 40, ""end_span"": 47, ""type"": ""Cellular_component""}]"	train
Chromatin immunoprecipitation assays with anti - E2Fs demonstrated the association of E2F family members with the E2F6 promoter in vivo.	Chromatin,0,9,Cellular_component	"[{""token"": ""Chromatin"", ""start_span"": 0, ""end_span"": 9, ""type"": ""Cellular_component""}]"	train
Moreover, chromatin immunoprecipitation experiments revealed that both E2F1 and 4 bind to the ARHI promoter in breast cancer cells in vivo.	chromatin,10,19,Cellular_component	"[{""token"": ""chromatin"", ""start_span"": 10, ""end_span"": 19, ""type"": ""Cellular_component""}]"	train
The main transcriptional activator that orchestrates this response is Msn2, whose nuclear localization and DNA binding are negatively controlled by the cAMP - dependent protein kinase ( PKA).	nuclear,82,89,Cellular_component	"[{""token"": ""nuclear"", ""start_span"": 82, ""end_span"": 89, ""type"": ""Cellular_component""}]"	train
Msn2 activation by sudden glucose depletion correlates with a fast but transient decrease in phosphorylation of several sites in its nuclear localization signal ( NLS).	nuclear,133,140,Cellular_component	"[{""token"": ""nuclear"", ""start_span"": 133, ""end_span"": 140, ""type"": ""Cellular_component""}]"	train
Here we show that protein phosphatase 1 ( PP1) is the direct antagonist of PKA - dependent phosphorylation at the Msn2 nuclear import domain and therefore a potential mediator of glucose starvation signals that target this transcription factor.	nuclear,119,126,Cellular_component	"[{""token"": ""nuclear"", ""start_span"": 119, ""end_span"": 126, ""type"": ""Cellular_component""}]"	train
Furthermore, exogenous LxVPc1 blocked NFATc2 phosphorylation and nuclear translocation in vivo.	nuclear,65,72,Cellular_component	"[{""token"": ""nuclear"", ""start_span"": 65, ""end_span"": 72, ""type"": ""Cellular_component""}]"	train
Retention of cohesins around centromeres until meiosis II is required for the accurate segregation of sister chromatids.	chromatids,109,119,Cellular_component	"[{""token"": ""chromatids"", ""start_span"": 109, ""end_span"": 119, ""type"": ""Cellular_component""}]"	train
Understanding the interplay between these processes should provide insight into the events underlying meiotic chromosome mis - segregation, the leading cause of miscarriages and mental retardation in humans.	chromosome,110,120,Cellular_component	"[{""token"": ""chromosome"", ""start_span"": 110, ""end_span"": 120, ""type"": ""Cellular_component""}]"	train
Chromatin immunoprecipitation ( ChIP) assay using primers that flanked the juxtaposed Puralpha and E2F - 1 binding sites verified the presence of Puralpha and E2F - 1 on the pPuralpha in vivo.	Chromatin,0,9,Cellular_component	"[{""token"": ""Chromatin"", ""start_span"": 0, ""end_span"": 9, ""type"": ""Cellular_component""}]"	train
Unexpectedly, the Wnt antagonist Dkk2 is required for terminal osteoblast differentiation and mineralized matrix formation.	matrix,106,112,Cellular_component	"[{""token"": ""matrix"", ""start_span"": 106, ""end_span"": 112, ""type"": ""Cellular_component""}]"	train
In this study, we investigated the signaling pathway involved in IL - 6 production caused by peptidoglycan ( PGN), a cell wall component of the Gram - positive bacterium, Staphylococcus aureus, in RAW 264. 7 macrophages.	cell wall,117,126,Cellular_component	"[{""token"": ""cell wall"", ""start_span"": 117, ""end_span"": 126, ""type"": ""Cellular_component""}]"	train
In budding yeast, Gin4, a Nim1 - related kinase, plays an important role in proper organization of the septin ring at the mother - bud neck, a filamentous structure that is critical for diverse cellular processes including mitotic entry and cytokinesis.	mother - bud neck,122,139,Cellular_component	"[{""token"": ""mother - bud neck"", ""start_span"": 122, ""end_span"": 139, ""type"": ""Cellular_component""}]"	train
Here we showed that a neck - associated Ser / Thr kinase Elm1, which is important for septin assembly, is critical for proper modification of Gin4 and its physiological substrate Shs1.	neck,22,26,Cellular_component	"[{""token"": ""neck"", ""start_span"": 22, ""end_span"": 26, ""type"": ""Cellular_component""}]"	train
Human cyclins A and B1 are differentially located in the cell and undergo cell cycle - dependent nuclear transport.	nuclear,97,104,Cellular_component	"[{""token"": ""nuclear"", ""start_span"": 97, ""end_span"": 104, ""type"": ""Cellular_component""}]"	train
We have used immunofluorescence staining to study the subcellular distribution of cyclin A and B1 during the somatic cell cycle.	subcellular,54,65,Cellular_component	"[{""token"": ""subcellular"", ""start_span"": 54, ""end_span"": 65, ""type"": ""Cellular_component""}]"	train
In both primary human fibroblasts and in epithelial tumor cells, we find that cyclin A is predominantly nuclear from S phase onwards.	nuclear,104,111,Cellular_component	"[{""token"": ""nuclear"", ""start_span"": 104, ""end_span"": 111, ""type"": ""Cellular_component""}]"	train
Cyclin B1 is associated with p34cdc2 in the cytoplasm.	cytoplasm,44,53,Cellular_component	"[{""token"": ""cytoplasm"", ""start_span"": 44, ""end_span"": 53, ""type"": ""Cellular_component""}]"	train
Furthermore, we find that Src - activated breast cancer lines show reduced p27 and observe a correlation between Src activation and reduced nuclear p27 in 482 primary human breast cancers.	nuclear,140,147,Cellular_component	"[{""token"": ""nuclear"", ""start_span"": 140, ""end_span"": 147, ""type"": ""Cellular_component""}]"	train
PRAS40 binds the mTOR kinase domain and its interaction with mTOR is induced under conditions that inhibit mTOR signalling, such as nutrient or serum deprivation or mitochondrial metabolic inhibition.	mitochondrial,165,178,Cellular_component	"[{""token"": ""mitochondrial"", ""start_span"": 165, ""end_span"": 178, ""type"": ""Cellular_component""}]"	train
Furthermore, PRAS40 phosphorylation by Akt and association with 14 - 3 - 3, a cytosolic anchor protein, are crucial for insulin to stimulate mTOR.	cytosolic,78,87,Cellular_component	"[{""token"": ""cytosolic"", ""start_span"": 78, ""end_span"": 87, ""type"": ""Cellular_component""}]"	train
We show that ACE2, whose zinc finger region is nearly identical to that of SWI5, shows patterns of cell cycle - regulated transcription and nuclear localization similar to those seen previously for SWI5.	nuclear,140,147,Cellular_component	"[{""token"": ""nuclear"", ""start_span"": 140, ""end_span"": 147, ""type"": ""Cellular_component""}]"	train
The control of cell growth, that is cell size, is largely controlled by mTOR ( the mammalian target of rapamycin), a large serine / threonine protein kinase that regulates ribosome biogenesis and protein translation.	ribosome,172,180,Cellular_component	"[{""token"": ""ribosome"", ""start_span"": 172, ""end_span"": 180, ""type"": ""Cellular_component""}]"	train
The yeast anaphase - promoting complex ( APC) subunit Mnd2 is necessary for maintaining sister chromatid cohesion in prophase I of meiosis by inhibiting premature ubiquitination and subsequent degradation of substrates by the APC ( Ama1) ubiquitin ligase.	sister chromatid,88,104,Cellular_component	"[{""token"": ""sister chromatid"", ""start_span"": 88, ""end_span"": 104, ""type"": ""Cellular_component""}]"	train
Similar to the MND2 deletion strain, cells harboring the alanine mutant that did not form spores arrested after premeiotic S phase with a single undivided nucleus and low levels of the APC ( Ama1) meiotic substrate, Clb5, relative to wild type cells.	nucleus,155,162,Cellular_component	"[{""token"": ""nucleus"", ""start_span"": 155, ""end_span"": 162, ""type"": ""Cellular_component""}]"	train
Taken together, these data suggest that mitotic phosphorylation of Mnd2 is necessary for APC - mediated progression beyond the first meiotic nuclear division.	nuclear,141,148,Cellular_component	"[{""token"": ""nuclear"", ""start_span"": 141, ""end_span"": 148, ""type"": ""Cellular_component""}]"	train
When phosphorylation of Mad3p at two sites is prevented, the cell ' s response to reduced kinetochore tension is dramatically curtailed.	kinetochore,90,101,Cellular_component	"[{""token"": ""kinetochore"", ""start_span"": 90, ""end_span"": 101, ""type"": ""Cellular_component""}]"	train
Our data provide strong evidence for a distinct checkpoint pathway responding to lack of sister kinetochore tension, in which Ipl1p - dependent phosphorylation of Mad3p is a key step.	kinetochore,96,107,Cellular_component	"[{""token"": ""kinetochore"", ""start_span"": 96, ""end_span"": 107, ""type"": ""Cellular_component""}]"	train
NGF - differentiation produced increased p53 levels, nuclear localization and sequence - specific DNA binding.	nuclear,53,60,Cellular_component	"[{""token"": ""nuclear"", ""start_span"": 53, ""end_span"": 60, ""type"": ""Cellular_component""}]"	train
Apoptosis in mitotic cells also produced these events but the accompanying activation of caspases 1 - 10 and mitochondrial depolarization were inhibited during NGF differentiation and could be reversed in p53 - silenced cells.	mitochondrial,109,122,Cellular_component	"[{""token"": ""mitochondrial"", ""start_span"": 109, ""end_span"": 122, ""type"": ""Cellular_component""}]"	train
Transcriptional regulation of PUMA and survivin expression were not inhibited by NGF, although NO - induced mitochondrial depolarization was dependent upon de novo gene transcription and only occurred in mitotic cells.	mitochondrial,108,121,Cellular_component	"[{""token"": ""mitochondrial"", ""start_span"": 108, ""end_span"": 121, ""type"": ""Cellular_component""}]"	train
We conclude that NGF mediates prosurvival signaling by increasing factors such as Bcl - 2 and p21 ( Waf1 / Cip1) without altering p53 transcriptional activity to inhibit mitochondrial depolarization, caspase activation and apoptosis.	mitochondrial,170,183,Cellular_component	"[{""token"": ""mitochondrial"", ""start_span"": 170, ""end_span"": 183, ""type"": ""Cellular_component""}]"	train
A Bir1p Sli15p kinetochore passenger complex regulates septin organization during anaphase.	kinetochore,15,26,Cellular_component	"[{""token"": ""kinetochore"", ""start_span"": 15, ""end_span"": 26, ""type"": ""Cellular_component""}]"	train
Kinetochore - passenger complexes in metazoans have been proposed to coordinate the segregation of chromosomes in anaphase with the induction of cytokinesis.	chromosomes,99,110,Cellular_component	"[{""token"": ""chromosomes"", ""start_span"": 99, ""end_span"": 110, ""type"": ""Cellular_component""}]"	train
Our recent work has implicated the passenger protein Bir1p ( Survivin) and the inner kinetochore complex centromere binding factor 3 ( CBF3) in the regulation of septin dynamics during anaphase.	kinetochore,85,96,Cellular_component	"[{""token"": ""kinetochore"", ""start_span"": 85, ""end_span"": 96, ""type"": ""Cellular_component""}]"	train
Neither conditional alleles nor mutants of BIR1 that disrupt the interaction between Bir1p and Sli15p resulted in mono - attached kinetochores, suggesting that the Bir1p - Sli15p complex functions in anaphase and independently from Sli15p - Ipl1p complexes.	kinetochores,130,142,Cellular_component	"[{""token"": ""kinetochores"", ""start_span"": 130, ""end_span"": 142, ""type"": ""Cellular_component""}]"	train
Finally, we have shown that cells lacking Rtt109 or expressing H3 - K56 mutants exhibited significant reduction in the association of three proteins with stalled DNA replication forks and hyper - recombination of replication forks stalled at replication fork barriers of the ribosomal DNA locus compared with wild - type cells.	ribosomal,275,284,Cellular_component	"[{""token"": ""ribosomal"", ""start_span"": 275, ""end_span"": 284, ""type"": ""Cellular_component""}]"	train
mTOR controls mitochondrial oxidative function through a YY1 - PGC - 1alpha transcriptional complex.	mitochondrial,14,27,Cellular_component	"[{""token"": ""mitochondrial"", ""start_span"": 14, ""end_span"": 27, ""type"": ""Cellular_component""}]"	train
Transcriptional complexes that contain peroxisome - proliferator - activated receptor coactivator ( PGC) - 1alpha control mitochondrial oxidative function to maintain energy homeostasis in response to nutrient and hormonal signals.	mitochondrial,122,135,Cellular_component	"[{""token"": ""mitochondrial"", ""start_span"": 122, ""end_span"": 135, ""type"": ""Cellular_component""}]"	train
However, it is unknown whether and how mTOR controls mitochondrial oxidative activities.	mitochondrial,53,66,Cellular_component	"[{""token"": ""mitochondrial"", ""start_span"": 53, ""end_span"": 66, ""type"": ""Cellular_component""}]"	train
Here we show that mTOR is necessary for the maintenance of mitochondrial oxidative function.	mitochondrial,59,72,Cellular_component	"[{""token"": ""mitochondrial"", ""start_span"": 59, ""end_span"": 72, ""type"": ""Cellular_component""}]"	train
Knockdown of YY1 caused a significant decrease in mitochondrial gene expression and in respiration, and YY1 was required for rapamycin - dependent repression of those genes.	mitochondrial,50,63,Cellular_component	"[{""token"": ""mitochondrial"", ""start_span"": 50, ""end_span"": 63, ""type"": ""Cellular_component""}]"	train
We have therefore identified a mechanism by which a nutrient sensor ( mTOR) balances energy metabolism by means of the transcriptional control of mitochondrial oxidative function.	mitochondrial,146,159,Cellular_component	"[{""token"": ""mitochondrial"", ""start_span"": 146, ""end_span"": 159, ""type"": ""Cellular_component""}]"	train
EXPERIMENTAL DESIGN: We studied the expression and subcellular localization of p53 and its isoforms in a panel of human melanoma cell lines using Western blot, two - dimensional electrophoresis, and reverse transcription - PCR.	subcellular,51,62,Cellular_component	"[{""token"": ""subcellular"", ""start_span"": 51, ""end_span"": 62, ""type"": ""Cellular_component""}]"	train
Furthermore, it was found that citral effectively inhibited the transcriptional activity and expression of iNOS, and potently suppressed the DNA binding activity and nuclear translocation of NF - kappa B as well as I kappa B phosphorylation in a concentration dependent manner.	nuclear,166,173,Cellular_component	"[{""token"": ""nuclear"", ""start_span"": 166, ""end_span"": 173, ""type"": ""Cellular_component""}]"	train
Anaphase is initiated when a ubiquitin ligase, the anaphase - promoting complex ( APC), triggers the destruction of securin, thereby allowing separase, a protease, to disrupt sister - chromatid cohesion.	sister - chromatid,175,193,Cellular_component	"[{""token"": ""sister - chromatid"", ""start_span"": 175, ""end_span"": 193, ""type"": ""Cellular_component""}]"	train
Consistent with this model, we show that mutations that disrupt securin phosphoregulation decrease the synchrony of chromosome segregation.	chromosome,116,126,Cellular_component	"[{""token"": ""chromosome"", ""start_span"": 116, ""end_span"": 126, ""type"": ""Cellular_component""}]"	train
A diverse array of intracellular signaling pathways has been suggested to transduce the signals exerted in cells when secreted ligands of the Wnt family bind to Frizzled receptors.	intracellular,19,32,Cellular_component	"[{""token"": ""intracellular"", ""start_span"": 19, ""end_span"": 32, ""type"": ""Cellular_component""}]"	train
Studies with a chimeric receptor composed of Frizzled - 2 and the beta2 - adrenergic receptor have suggested that the binding of Wnt - 5a to Frizzled - 2 results in the activation of G proteins of the Galpha ( i) family, the mobilization of calcium from intracellular stores and the induction of gene transcription through nuclear factor of activated T cells.	intracellular stores,254,274,Cellular_component	"[{""token"": ""intracellular stores"", ""start_span"": 254, ""end_span"": 274, ""type"": ""Cellular_component""}]"	train
Detection of myeloid differentiating factor 88 ( MyD88) - TLR2 complex confirmed interaction between the two for triggering the downstream signaling, which ultimately led to TLR2 - dependent nuclear translocation of nuclear factor - kappa B.	nuclear,191,198,Cellular_component	"[{""token"": ""nuclear"", ""start_span"": 191, ""end_span"": 198, ""type"": ""Cellular_component""}]"	train
Induction of messenger ribonucleic acid for the chemokines, macrophage - inflammatory protein ( MIP) - 1alpha, MIP - 1beta and regulated upon activation, normal T cell expressed and secreted indicated a strong bias of PIL for type 1 polarization that was supported by the intracellular expression and release of tumor necrosis factor ( TNF) - alpha and IL - 12.	intracellular,272,285,Cellular_component	"[{""token"": ""intracellular"", ""start_span"": 272, ""end_span"": 285, ""type"": ""Cellular_component""}]"	train
Delivery outcomes, fetal status, serum progesterone, and nuclear translocation of the transcription factor nuclear factor kappa B ( NFkappaB) were determined.	nuclear,57,64,Cellular_component	"[{""token"": ""nuclear"", ""start_span"": 57, ""end_span"": 64, ""type"": ""Cellular_component""}]"	train
Intrauterine fetal survival, maintenance of circulating progesterone levels, and nuclear translocation of NFkappaB were also dependent upon MyD88 but not TRIF.	nuclear,81,88,Cellular_component	"[{""token"": ""nuclear"", ""start_span"": 81, ""end_span"": 88, ""type"": ""Cellular_component""}]"	train
By screening a diverse synthetic chemical library, we have discovered two new classes of small molecules that disrupt Wnt pathway responses; whereas one class inhibits the activity of Porcupine, a membrane - bound acyltransferase that is essential to the production of Wnt proteins, the other abrogates destruction of Axin proteins, which are suppressors of Wnt / beta - catenin pathway activity.	membrane,197,205,Cellular_component	"[{""token"": ""membrane"", ""start_span"": 197, ""end_span"": 205, ""type"": ""Cellular_component""}]"	train
Strikingly, Licochalcone A significantly inhibited LPS - induced NF - kappaB transcriptional activation; however, it had no effect on not only the phosphorylation and degradation of IkappaBalpha but also nuclear translocation and DNA binding activity of NF - kappaB p65.	nuclear,204,211,Cellular_component	"[{""token"": ""nuclear"", ""start_span"": 204, ""end_span"": 211, ""type"": ""Cellular_component""}]"	train
We also show nuclear exclusion of p53 in a PI 3 - kinase - dependent manner.	nuclear,13,20,Cellular_component	"[{""token"": ""nuclear"", ""start_span"": 13, ""end_span"": 20, ""type"": ""Cellular_component""}]"	train
Inhibition of the Akt / Hdm2 pathway by Notch1 signaling was responsible for the suppression of p53 proteasomal degradation, thus contributing to the Notch1 signaling - mediated up - regulation of p53 expression.	proteasomal,100,111,Cellular_component	"[{""token"": ""proteasomal"", ""start_span"": 100, ""end_span"": 111, ""type"": ""Cellular_component""}]"	train
Treatments with 100 muM PDTC did not inhibit the phosphorylation of p - ERK1 / 2, p - P38, and p - JNK, or the transnuclear migration of NF - kappaB through degradation of IkappaB - alpha in IL - 1beta - stimulated FLSs.	transnuclear,111,123,Cellular_component	"[{""token"": ""transnuclear"", ""start_span"": 111, ""end_span"": 123, ""type"": ""Cellular_component""}]"	train
NEMO stabilizes c - Myc through direct interaction in the nucleus.	nucleus,58,65,Cellular_component	"[{""token"": ""nucleus"", ""start_span"": 58, ""end_span"": 65, ""type"": ""Cellular_component""}]"	train
NF - kappaB essential modulator ( NEMO) caused phosphorylation and stabilization of c - Myc protein in the nucleus through direct interaction.	nucleus,107,114,Cellular_component	"[{""token"": ""nucleus"", ""start_span"": 107, ""end_span"": 114, ""type"": ""Cellular_component""}]"	train
Interaction between nuclear insulin receptor substrate - 2 and NF - kappaB in IGF - 1 induces response in breast cancer cells.	nuclear,20,27,Cellular_component	"[{""token"": ""nuclear"", ""start_span"": 20, ""end_span"": 27, ""type"": ""Cellular_component""}]"	train
In addition, IGF - 1 promote nuclear translocation of IRS - 2 and NF - kappaB in MCF - 7 and BT - 20 cells.	nuclear,29,36,Cellular_component	"[{""token"": ""nuclear"", ""start_span"": 29, ""end_span"": 36, ""type"": ""Cellular_component""}]"	train
Nuclear IRS - 2 interaction with NF - kappaB - p65 and PI3K binding tyrosine residues of IRS - 2 are crucial for the NF - kappaB activities.	Nuclear,0,7,Cellular_component	"[{""token"": ""Nuclear"", ""start_span"": 0, ""end_span"": 7, ""type"": ""Cellular_component""}]"	train
Moreover, nuclear IRS - 2 is recruited to the cyclin D1 promoter both in MCF - 7 and BT - 20 cells.	nuclear,10,17,Cellular_component	"[{""token"": ""nuclear"", ""start_span"": 10, ""end_span"": 17, ""type"": ""Cellular_component""}]"	train
Our studies suggest that IRS - 2 plays a significant role by activating, at least in part, NF - kappaB via PI3K / Akt pathway in IGF - 1 - induced responses in breast cancer cells and the crosstalk between nuclear IRS - 2 and NF - kappaB might be responsible for transcriptional progression of the breast cancer cells.	nuclear,206,213,Cellular_component	"[{""token"": ""nuclear"", ""start_span"": 206, ""end_span"": 213, ""type"": ""Cellular_component""}]"	train
The difference between the effects of ROS and NO on AT ( 1) R expression may be caused by the difference between intracellular location of ROS signaling and that of NO signaling, as the agonist - induced S - nitrosylation of NF - kappaB requires a local interaction between NO synthase ( NOS) and NF - kappaB in the perinuclear region.	intracellular,113,126,Cellular_component	"[{""token"": ""intracellular"", ""start_span"": 113, ""end_span"": 126, ""type"": ""Cellular_component""}]"	train
Negative feedback regulation of NF - kappaB action by CITED2 in the nucleus.	nucleus,68,75,Cellular_component	"[{""token"": ""nucleus"", ""start_span"": 68, ""end_span"": 75, ""type"": ""Cellular_component""}]"	train
Mechanistically, CITED2 constitutively localizes inside the nucleus and interacts specifically with the coactivator p300.	nucleus,60,67,Cellular_component	"[{""token"": ""nucleus"", ""start_span"": 60, ""end_span"": 67, ""type"": ""Cellular_component""}]"	train
Collectively, this study identifies CITED2 as a novel regulator of NF - kappaB in the nucleus, which reveals a negative feedback mechanism for NF - kappaB signaling.	nucleus,86,93,Cellular_component	"[{""token"": ""nucleus"", ""start_span"": 86, ""end_span"": 93, ""type"": ""Cellular_component""}]"	train
TGF - beta1 affected neither TNF - alpha - induced IkappaBalpha phosphorylation and subsequent degradation, nor p65 NF - kappaB phosphorylation and its nuclear translocation.	nuclear,152,159,Cellular_component	"[{""token"": ""nuclear"", ""start_span"": 152, ""end_span"": 159, ""type"": ""Cellular_component""}]"	train
However, TGF - beta1 could inhibit p65 and p50 binding to the kappaB site in human RANTES promoter as revealed by chromatin immunoprecipitation assay and protein - DNA binding assay.	chromatin,114,123,Cellular_component	"[{""token"": ""chromatin"", ""start_span"": 114, ""end_span"": 123, ""type"": ""Cellular_component""}]"	train
Moreover, nuclear translocation of Keap1 was augmented by p65.	nuclear,10,17,Cellular_component	"[{""token"": ""nuclear"", ""start_span"": 10, ""end_span"": 17, ""type"": ""Cellular_component""}]"	train
Consistently, chromatin immunoprecipitation revealed a specific interaction of CD44 promoter with RelB - containing complex.	chromatin,14,23,Cellular_component	"[{""token"": ""chromatin"", ""start_span"": 14, ""end_span"": 23, ""type"": ""Cellular_component""}]"	train
NF - kappaB repressing factor ( NRF) is a nuclear transcription factor that binds to a specific DNA sequence in NF - kappaB target promoters.	nuclear,42,49,Cellular_component	"[{""token"": ""nuclear"", ""start_span"": 42, ""end_span"": 49, ""type"": ""Cellular_component""}]"	train
Fas - associated protein with death domain ( FADD) is a cytosolic adapter protein essential for mediating death receptor - induced apoptosis.	cytosolic,56,65,Cellular_component	"[{""token"": ""cytosolic"", ""start_span"": 56, ""end_span"": 65, ""type"": ""Cellular_component""}]"	train
Human TNFAIP3 interacting protein 1 ( TNIP1) has diverse functions including support of HIV replication through its interaction with viral Nef and matrix proteins, reduction of TNFalpha - induced signaling through its interaction with NF - kappaB pathway proteins, and corepression of agonist - bound retinoic acid receptors and peroxisome proliferator - activated receptors ( PPAR).	matrix,147,153,Cellular_component	"[{""token"": ""matrix"", ""start_span"": 147, ""end_span"": 153, ""type"": ""Cellular_component""}]"	train
We tested NF - kappaB and PPAR regulation of the endogenous TNIP1 gene and cloned promoter by expression studies, electrophoretic mobility shift assays, and chromatin immunoprecipitations.	chromatin,157,166,Cellular_component	"[{""token"": ""chromatin"", ""start_span"": 157, ""end_span"": 166, ""type"": ""Cellular_component""}]"	train
AML1 / RUNX1 functions as a cytoplasmic attenuator of NF - kappaB signaling in the repression of myeloid tumors.	cytoplasmic,28,39,Cellular_component	"[{""token"": ""cytoplasmic"", ""start_span"": 28, ""end_span"": 39, ""type"": ""Cellular_component""}]"	train
Transcription factor AML1 / RUNX1 is one of the most frequent targets of chromosomal abnormalities in human leukemia and altered function of AML1 is closely associated with malignant transformation of hematopoietic cells.	chromosomal,73,84,Cellular_component	"[{""token"": ""chromosomal"", ""start_span"": 73, ""end_span"": 84, ""type"": ""Cellular_component""}]"	train
We found that AML1 inhibits NF - kappaB signaling through interaction with IkappaB kinase complex in the cytoplasm.	cytoplasm,105,114,Cellular_component	"[{""token"": ""cytoplasm"", ""start_span"": 105, ""end_span"": 114, ""type"": ""Cellular_component""}]"	train
These findings reveal a novel role for AML1 as a cytoplasmic attenuator of NF - kappaB signaling and indicate that NF - kappaB signaling is one of the promising therapeutic targets of hematologic malignancies with AML1 abnormality.	cytoplasmic,49,60,Cellular_component	"[{""token"": ""cytoplasmic"", ""start_span"": 49, ""end_span"": 60, ""type"": ""Cellular_component""}]"	train
Despite no existing kappaB consensus sequence in the COL1A1 promoter, we found that Sp1 / Sp3 / c - Krox and NF - kappaB bind and / or are recruited on the proximal promoter in chromatin immunoprecipitation ( ChIP) assays.	chromatin,177,186,Cellular_component	"[{""token"": ""chromatin"", ""start_span"": 177, ""end_span"": 186, ""type"": ""Cellular_component""}]"	train
Indeed, biochemical, imaging and immunoprecipitation studies reveal a novel inhibitory mechanism whereby Tir interaction with cytoplasm - located TNFalpha receptor - associated factor ( TRAF) adaptor proteins induces their proteasomal - independent degradation.	proteasomal,223,234,Cellular_component	"[{""token"": ""proteasomal"", ""start_span"": 223, ""end_span"": 234, ""type"": ""Cellular_component""}]"	train
Gene set enrichment analysis of transcriptome profiles of Erg and NF - kappaB - dependent genes, together with chromatin immunoprecipitation ( ChIP) studies, reveals that this mechanism is common to other proinflammatory genes, including cIAP - 2 and IL - 8.	chromatin,111,120,Cellular_component	"[{""token"": ""chromatin"", ""start_span"": 111, ""end_span"": 120, ""type"": ""Cellular_component""}]"	train
The NFkappaB family of transcription factors responds to inflammatory cytokines with rapid transcriptional activation, in which NFkappaB enters the nucleus and binds DNA.	nucleus,148,155,Cellular_component	"[{""token"": ""nucleus"", ""start_span"": 148, ""end_span"": 155, ""type"": ""Cellular_component""}]"	train
Just as rapidly as transcription is activated, it is subsequently repressed by newly synthesized IkappaBalpha? that also enters the nucleus and removes NFkappaB from the DNA.	nucleus,132,139,Cellular_component	"[{""token"": ""nucleus"", ""start_span"": 132, ""end_span"": 139, ""type"": ""Cellular_component""}]"	train
Kinetic properties of the plasma membrane Na + - H + exchanger.	plasma membrane,26,41,Cellular_component	"[{""token"": ""plasma membrane"", ""start_span"": 26, ""end_span"": 41, ""type"": ""Cellular_component""}]"	train
The plasma membrane Na + - H + exchanger is a ubiquitous transport system that participates in diverse cell functions involving the cellular uptake of Na + or extrusion of H +.	plasma membrane,4,19,Cellular_component	"[{""token"": ""plasma membrane"", ""start_span"": 4, ""end_span"": 19, ""type"": ""Cellular_component""}]"	train
This property enables the Na + - H + exchanger to play an important role in the regulation of intracellular pH.	intracellular,94,107,Cellular_component	"[{""token"": ""intracellular"", ""start_span"": 94, ""end_span"": 107, ""type"": ""Cellular_component""}]"	train
Quantitation of the efflux of acylcarnitines from rat heart, brain, and liver mitochondria.	mitochondria,78,90,Cellular_component	"[{""token"": ""mitochondria"", ""start_span"": 78, ""end_span"": 90, ""type"": ""Cellular_component""}]"	train
The efflux of individual short - chain and medium - chain acylcarnitines from rat liver, heart, and brain mitochondria metabolizing several substrates has been measured.	mitochondria,106,118,Cellular_component	"[{""token"": ""mitochondria"", ""start_span"": 106, ""end_span"": 118, ""type"": ""Cellular_component""}]"	train
The acylcarnitine efflux profiles depend on the substrate, the source of mitochondria, and the incubation conditions.	mitochondria,73,85,Cellular_component	"[{""token"": ""mitochondria"", ""start_span"": 73, ""end_span"": 85, ""type"": ""Cellular_component""}]"	train
The largest amount of any acylcarnitine effluxing per mg of protein was acetylcarnitine produced by heart mitochondria from pyruvate.	mitochondria,106,118,Cellular_component	"[{""token"": ""mitochondria"", ""start_span"": 106, ""end_span"": 118, ""type"": ""Cellular_component""}]"	train
This efflux of acetylcarnitine from heart mitochondria is almost 5 times greater with 1 mM than 0. 2 mM carnitine.	mitochondria,42,54,Cellular_component	"[{""token"": ""mitochondria"", ""start_span"": 42, ""end_span"": 54, ""type"": ""Cellular_component""}]"	train
Very little acetylcarnitine effluxes from heart mitochondria when octanoate is the substrate except in the presence of malonate.	mitochondria,48,60,Cellular_component	"[{""token"": ""mitochondria"", ""start_span"": 48, ""end_span"": 60, ""type"": ""Cellular_component""}]"	train
The unequivocal demonstration that considerable amounts of propionylcarnitine or isobutyrylcarnitine efflux from heart mitochondria metabolizing alpha - ketoisovalerate and alpha - keto - beta - methylvalerate provides evidence for a role ( via removal of non - metabolizable propionyl - CoA or slowly metabolizable acyl - CoAs) for carnitine in tissues which have limited capacity to metabolize propionyl - CoA.	mitochondria,119,131,Cellular_component	"[{""token"": ""mitochondria"", ""start_span"": 119, ""end_span"": 131, ""type"": ""Cellular_component""}]"	train
Lysosomal enzyme preparations from chick embryo chondrocytes and from two normal human fibroblast cell lines catalyzed the removal of the 2 - O - SO4 substituent from the uronic acid residues of IdoA ( 2 - SO4) - [ 3H] AManR ( 6 - SO4), GlcA ( 2 - SO4) - [ 3H] AManR ( 6 - SO4), and GlcA ( 2 - SO4) - [ 3H] ATalR ( 6 - SO4).	Lysosomal,0,9,Cellular_component	"[{""token"": ""Lysosomal"", ""start_span"": 0, ""end_span"": 9, ""type"": ""Cellular_component""}]"	train
In contrast, a lysosomal enzyme preparation from a human fibroblast cell line deficient in idurono - 2 - sulfatase ( Hunter ' s - syndrome), which had no activity on the IdoA ( 2 - SO4) - [ 3H] AManR ( 6 - SO4), converted GlcA ( 2 - SO4) - [ 3H] AManR ( 6 - SO4) to a mixture of GlcA - [ 3H] AManR ( 6 - SO4) and [ 3H] AManR ( 6 - SO4).	lysosomal,15,24,Cellular_component	"[{""token"": ""lysosomal"", ""start_span"": 15, ""end_span"": 24, ""type"": ""Cellular_component""}]"	train
The IL - 1R AcP is a member of the Ig superfamily by analysis of its putative extracellular domain and also bears limited homology throughout the protein to both Type I and Type II IL - 1 receptors.	extracellular,78,91,Cellular_component	"[{""token"": ""extracellular"", ""start_span"": 78, ""end_span"": 91, ""type"": ""Cellular_component""}]"	train
The Ras - like GTPase Cdc42 is essential for cell polarity and bud site assembly in Saccharomyces cerevisiae by regulating cell cycle - dependent reorganization of cortical cytoskeletal elements.	cytoskeletal elements,173,194,Cellular_component	"[{""token"": ""cytoskeletal elements"", ""start_span"": 173, ""end_span"": 194, ""type"": ""Cellular_component""}]"	train
Microsomal arylacetamide deacetylase ( DAC) competes against the activity of cytosolic arylamine N - acetyltransferase, which catalyzes one of the initial biotransformation pathways for arylamine and heterocyclic amine carcinogens in many species and tissues.	cytosolic,77,86,Cellular_component	"[{""token"": ""cytosolic"", ""start_span"": 77, ""end_span"": 86, ""type"": ""Cellular_component""}]"	train
These findings demonstrate that there is a cytosolic pathway for folding tubulin and actin in vivo that involves the TCP1 complex.	cytosolic,43,52,Cellular_component	"[{""token"": ""cytosolic"", ""start_span"": 43, ""end_span"": 52, ""type"": ""Cellular_component""}]"	train
The NF - kappa B precursor p105 and the proto - oncogene product Bcl - 3 are I kappa B molecules and control nuclear translocation of NF - kappa B.	nuclear,109,116,Cellular_component	"[{""token"": ""nuclear"", ""start_span"": 109, ""end_span"": 116, ""type"": ""Cellular_component""}]"	train
Similar to an I kappa B molecule, p105 associates in the cytoplasm with p50 or p65.	cytoplasm,57,66,Cellular_component	"[{""token"": ""cytoplasm"", ""start_span"": 57, ""end_span"": 66, ""type"": ""Cellular_component""}]"	train
Through this assembly, p105 efficiently blocks nuclear transfer of either subunit.	nuclear,47,54,Cellular_component	"[{""token"": ""nuclear"", ""start_span"": 47, ""end_span"": 54, ""type"": ""Cellular_component""}]"	train
The proto - oncogene product Bcl - 3 also controls nuclear translocation of p50, but not of p65.	nuclear,51,58,Cellular_component	"[{""token"": ""nuclear"", ""start_span"": 51, ""end_span"": 58, ""type"": ""Cellular_component""}]"	train
Hence, p50 can be retained in the cytoplasm via at least three distinct interactions: through direct interactions either with its own precursor, with Bcl - 3 or indirectly through I kappa B alpha or - beta when attached to p65.	cytoplasm,34,43,Cellular_component	"[{""token"": ""cytoplasm"", ""start_span"": 34, ""end_span"": 43, ""type"": ""Cellular_component""}]"	train
We discuss a function of p105 as a cytoplasmic assembly unit for homo - and heteromeric NF - kappa B complexes and of Bcl - 3 as an I kappa B with novel subunit specificity.	cytoplasmic,35,46,Cellular_component	"[{""token"": ""cytoplasmic"", ""start_span"": 35, ""end_span"": 46, ""type"": ""Cellular_component""}]"	train
Activation of phosphatidylcholine - specific phospholipase D ( PLD) has been implicated as a critical step in numerous cellular pathways, including signal transduction, membrane trafficking, and the regulation of mitosis.	membrane,169,177,Cellular_component	"[{""token"": ""membrane"", ""start_span"": 169, ""end_span"": 177, ""type"": ""Cellular_component""}]"	train
Characterization of recombinant human PLD1 reveals that it is membrane - associated, selective for phosphatidylcholine, stimulated by phosphatidylinositol 4, 5 - bisphosphate, activated by the monomeric G - protein ADP - ribosylation factor - 1, and inhibited by oleate.	membrane,62,70,Cellular_component	"[{""token"": ""membrane"", ""start_span"": 62, ""end_span"": 70, ""type"": ""Cellular_component""}]"	train
Biochemical analysis reveals that protein kinase C autophosphorylates on S660, that autophosphorylation on S660 follows T641 autophosphorylation, that autophosphorylation on S660 is accompanied by the release of protein kinase C into the cytosol, and that T500 is not an autophosphorylation site.	cytosol,238,245,Cellular_component	"[{""token"": ""cytosol"", ""start_span"": 238, ""end_span"": 245, ""type"": ""Cellular_component""}]"	train
Thirdly, a second autophosphorylation on the carboxyl terminus ( S660) regulates the enzyme ' s subcellular localization.	subcellular,96,107,Cellular_component	"[{""token"": ""subcellular"", ""start_span"": 96, ""end_span"": 107, ""type"": ""Cellular_component""}]"	train
Adenosine kinase is ubiquitous in eukaryotes and is a key enzyme in the regulation of the intracellular levels of adenosine, an important physiological effector of many cells and tissues.	intracellular,90,103,Cellular_component	"[{""token"": ""intracellular"", ""start_span"": 90, ""end_span"": 103, ""type"": ""Cellular_component""}]"	train
A membrane - bound kinase capable of phosphorylating residue Thr14, the Myt1 kinase, has been identified in the frog Xenopus laevis and more recently in human.	membrane,2,10,Cellular_component	"[{""token"": ""membrane"", ""start_span"": 2, ""end_span"": 10, ""type"": ""Cellular_component""}]"	train
Analysis of endogenous Myt1 demonstrates that it remains membrane - bound throughout the cell cycle, but its kinase activity decreased during M phase arrest, when Myt1 became hyperphosphorylated.	membrane,57,65,Cellular_component	"[{""token"": ""membrane"", ""start_span"": 57, ""end_span"": 65, ""type"": ""Cellular_component""}]"	train
Crystal structure of a calcium - phospholipid binding domain from cytosolic phospholipase A2.	cytosolic,66,75,Cellular_component	"[{""token"": ""cytosolic"", ""start_span"": 66, ""end_span"": 75, ""type"": ""Cellular_component""}]"	train
Cytosolic phospholipase A2 ( cPLA2) is a calcium - sensitive 85 - kDa enzyme that hydrolyzes arachidonic acid - containing membrane phospholipids to initiate the biosynthesis of eicosanoids and platelet - activating factor, potent inflammatory mediators.	membrane,123,131,Cellular_component	"[{""token"": ""membrane"", ""start_span"": 123, ""end_span"": 131, ""type"": ""Cellular_component""}]"	train
This region, along with an adjoining strip of basic residues, appear to constitute the membrane binding motif.	membrane,87,95,Cellular_component	"[{""token"": ""membrane"", ""start_span"": 87, ""end_span"": 95, ""type"": ""Cellular_component""}]"	train
The structure provides a striking insight into the relative importance of hydrophobic and electrostatic components of membrane binding for cPLA2.	membrane,118,126,Cellular_component	"[{""token"": ""membrane"", ""start_span"": 118, ""end_span"": 126, ""type"": ""Cellular_component""}]"	train
The human lymphoid cell activation antigen CD39 is a known E - type apyrase that hydrolyzes extracellular ATP and ADP, a function important in homotypic adhesion, platelet aggregation, and removal by activated lymphocytes of the lytic effect of ATP.	extracellular,92,105,Cellular_component	"[{""token"": ""extracellular"", ""start_span"": 92, ""end_span"": 105, ""type"": ""Cellular_component""}]"	train
The recently identified putative rat homologue of CD39L1 has been shown to have E - type ecto - ATPase activity, by hydrolyzing extracellular ATP.	extracellular,128,141,Cellular_component	"[{""token"": ""extracellular"", ""start_span"": 128, ""end_span"": 141, ""type"": ""Cellular_component""}]"	train
CD39L2, CD39L3, and CD39L4 were mapped on the human genome, and the murine homologues identified with the putative map locations were assigned on the basis of regions of conserved gene order between human and mouse chromosomes.	chromosomes,215,226,Cellular_component	"[{""token"": ""chromosomes"", ""start_span"": 215, ""end_span"": 226, ""type"": ""Cellular_component""}]"	train
Nuclear export of the stress - activated protein kinase p38 mediated by its substrate MAPKAP kinase - 2.	Nuclear,0,7,Cellular_component	"[{""token"": ""Nuclear"", ""start_span"": 0, ""end_span"": 7, ""type"": ""Cellular_component""}]"	train
This translocation to the nucleus is essential to MAP kinase signalling because it enables the kinase to phosphorylate transcription factors.	nucleus,26,33,Cellular_component	"[{""token"": ""nucleus"", ""start_span"": 26, ""end_span"": 33, ""type"": ""Cellular_component""}]"	train
RESULTS: The p38 SAP kinase substrate MAP - kinase - activated protein kinase - 2 ( MAPKAP kinase - 2) contains a putative nuclear localisation signal which we show is functional and required for activation by a variety of stimuli.	nuclear,123,130,Cellular_component	"[{""token"": ""nuclear"", ""start_span"": 123, ""end_span"": 130, ""type"": ""Cellular_component""}]"	train
Regulation of Saccharomyces cerevisiae kinetochores by the type 1 phosphatase Glc7p.	kinetochores,39,51,Cellular_component	"[{""token"": ""kinetochores"", ""start_span"": 39, ""end_span"": 51, ""type"": ""Cellular_component""}]"	valid
We have investigated the role of protein phosphorylation in regulation of Saccharomyces cerevisiae kinetochores.	kinetochores,99,111,Cellular_component	"[{""token"": ""kinetochores"", ""start_span"": 99, ""end_span"": 111, ""type"": ""Cellular_component""}]"	valid
Furthermore, addition of recombinant Ndc10p reconstitutes the microtubule - binding activity of a glc7 - 10 extract to wild - type levels.	microtubule,62,73,Cellular_component	"[{""token"": ""microtubule"", ""start_span"": 62, ""end_span"": 73, ""type"": ""Cellular_component""}]"	valid
Cloning, functional expression, gene structure, and chromosomal localization.	chromosomal,52,63,Cellular_component	"[{""token"": ""chromosomal"", ""start_span"": 52, ""end_span"": 63, ""type"": ""Cellular_component""}]"	valid
The cDNA codes for a protein of 635 amino acids with 12 transmembrane domains and 4 putative sites for N - linked glycosylation.	transmembrane,56,69,Cellular_component	"[{""token"": ""transmembrane"", ""start_span"": 56, ""end_span"": 69, ""type"": ""Cellular_component""}]"	valid
We also report here on the structural organization and chromosomal localization of the human SMVT gene.	chromosomal,55,66,Cellular_component	"[{""token"": ""chromosomal"", ""start_span"": 55, ""end_span"": 66, ""type"": ""Cellular_component""}]"	valid
The SMVT gene is located on chromosome 2p23 as evidenced by somatic cell hybrid analysis and fluorescence in situ hybridization.	chromosome 2p23,28,43,Cellular_component	"[{""token"": ""chromosome 2p23"", ""start_span"": 28, ""end_span"": 43, ""type"": ""Cellular_component""}]"	valid
We cloned the cDNA of this enzyme to enable characterization of the recombinant protein, determine its expression in different tissues, and determine the chromosome location of the gene.	chromosome,154,164,Cellular_component	"[{""token"": ""chromosome"", ""start_span"": 154, ""end_span"": 164, ""type"": ""Cellular_component""}]"	valid
Hsl1 localizes to the incipient site of cytokinesis in the bud neck in a septin - dependent manner; however, the function of Hsl7 was not previously known.	bud neck,59,67,Cellular_component	"[{""token"": ""bud neck"", ""start_span"": 59, ""end_span"": 67, ""type"": ""Cellular_component""}]"	valid
Using both indirect immunofluorescence with anti - Hsl7 antibodies and a fusion of Hsl7 to green fluorescent protein, we found that Hsl7 also localizes to the bud neck, congruent with the septin ring that faces the daughter cell.	bud neck,159,167,Cellular_component	"[{""token"": ""bud neck"", ""start_span"": 159, ""end_span"": 167, ""type"": ""Cellular_component""}]"	valid
Moreover, Hsl7 does not localize to the bud neck in an hsl1Delta mutant, whereas Hsl1 is localized normally in an hsl7Delta mutant.	bud neck,40,48,Cellular_component	"[{""token"": ""bud neck"", ""start_span"": 40, ""end_span"": 48, ""type"": ""Cellular_component""}]"	valid
Protein - protein interactions are now recognized as important mechanisms that target individual PKCs to different intracellular compartments and confer selectivity by associating individual isozymes with specific substrates.	intracellular compartments,115,141,Cellular_component	"[{""token"": ""intracellular compartments"", ""start_span"": 115, ""end_span"": 141, ""type"": ""Cellular_component""}]"	valid
Differential roles of TLR2 and TLR4 in recognition of gram - negative and gram - positive bacterial cell wall components.	cell wall,100,109,Cellular_component	"[{""token"": ""cell wall"", ""start_span"": 100, ""end_span"": 109, ""type"": ""Cellular_component""}]"	valid
Toll - like receptor ( TLR) 2 and TLR4 are implicated in the recognition of various bacterial cell wall components, such as lipopolysaccharide ( LPS).	cell wall,94,103,Cellular_component	"[{""token"": ""cell wall"", ""start_span"": 94, ""end_span"": 103, ""type"": ""Cellular_component""}]"	valid
TLR2 - deficient macrophages were hyporesponsive to several Gram - positive bacterial cell walls as well as Staphylococcus aureus peptidoglycan.	cell walls,86,96,Cellular_component	"[{""token"": ""cell walls"", ""start_span"": 86, ""end_span"": 96, ""type"": ""Cellular_component""}]"	valid
These results demonstrate that TLR2 and TLR4 recognize different bacterial cell wall components in vivo and TLR2 plays a major role in Gram - positive bacterial recognition.	cell wall,75,84,Cellular_component	"[{""token"": ""cell wall"", ""start_span"": 75, ""end_span"": 84, ""type"": ""Cellular_component""}]"	valid
Nuclear - specific degradation of Far1 is controlled by the localization of the F - box protein Cdc4.	Nuclear,0,7,Cellular_component	"[{""token"": ""Nuclear"", ""start_span"": 0, ""end_span"": 7, ""type"": ""Cellular_component""}]"	valid
In response to mating pheromones, a fraction of Far1 was stabilized after its export into the cytoplasm by Ste21 / Msn5.	cytoplasm,94,103,Cellular_component	"[{""token"": ""cytoplasm"", ""start_span"": 94, ""end_span"": 103, ""type"": ""Cellular_component""}]"	valid
Our results illustrate the importance of subcellular localization of F - box proteins, and provide an example of how an extracellular signal regulates protein stability at the level of substrate localization.	subcellular,41,52,Cellular_component	"[{""token"": ""subcellular"", ""start_span"": 41, ""end_span"": 52, ""type"": ""Cellular_component""}]"	valid
PIG - M encodes a new type of mannosyltransferase of 423 amino acids, bearing multiple transmembrane domains.	transmembrane,87,100,Cellular_component	"[{""token"": ""transmembrane"", ""start_span"": 87, ""end_span"": 100, ""type"": ""Cellular_component""}]"	valid
Human neuron - committed teratocarcinoma NT2 cell line has abnormal ND10 structures and is poorly infected by herpes simplex virus type 1.	ND10 structures,68,83,Cellular_component	"[{""token"": ""ND10 structures"", ""start_span"": 68, ""end_span"": 83, ""type"": ""Cellular_component""}]"	valid
Chromatin immunoprecipitations show that Rb is necessary to direct methylation of histone H3, and is necessary for binding of HP1 to the cyclin E promoter.	Chromatin,0,9,Cellular_component	"[{""token"": ""Chromatin"", ""start_span"": 0, ""end_span"": 9, ""type"": ""Cellular_component""}]"	valid
We purified membrane - based p70S6K as a kinase responsible for site - specific phosphorylation of BAD, which inactivates this proapoptotic molecule.	membrane,12,20,Cellular_component	"[{""token"": ""membrane"", ""start_span"": 12, ""end_span"": 20, ""type"": ""Cellular_component""}]"	valid
We found that the inhibition of ODC by alpha - difluoromethylornithine ( DFMO) resulted in a approximately 50% decrease in intracellular putrescine levels within 1 h.	intracellular,123,136,Cellular_component	"[{""token"": ""intracellular"", ""start_span"": 123, ""end_span"": 136, ""type"": ""Cellular_component""}]"	valid
NF - kappa B is activated by DFMO through the degradation of the inhibitory protein I kappa B alpha that sequesters NF - kappa B in the cytoplasm.	cytoplasm,136,145,Cellular_component	"[{""token"": ""cytoplasm"", ""start_span"": 136, ""end_span"": 145, ""type"": ""Cellular_component""}]"	valid
Nucleocytoplasmic shuttling of p130 / RBL2: novel regulatory mechanism.	Nucleocytoplasmic,0,17,Cellular_component	"[{""token"": ""Nucleocytoplasmic"", ""start_span"": 0, ""end_span"": 17, ""type"": ""Cellular_component""}]"	valid
The transcriptional activity of E2Fs is controlled by alteration of their nucleocytoplasmic localization during the cell cycle.	nucleocytoplasmic,74,91,Cellular_component	"[{""token"": ""nucleocytoplasmic"", ""start_span"": 74, ""end_span"": 91, ""type"": ""Cellular_component""}]"	valid
In addition to the C - terminal NLS, the intact pocket domain of p130 itself was sufficient for nuclear translocation.	nuclear,96,103,Cellular_component	"[{""token"": ""nuclear"", ""start_span"": 96, ""end_span"": 103, ""type"": ""Cellular_component""}]"	valid
An N - terminal domain that conferred cytoplasmic localization was identified.	cytoplasmic,38,49,Cellular_component	"[{""token"": ""cytoplasmic"", ""start_span"": 38, ""end_span"": 49, ""type"": ""Cellular_component""}]"	valid
A model suggesting that the activity of pRb family members can be regulated by intracellular trafficking of the proteins is proposed.	intracellular,79,92,Cellular_component	"[{""token"": ""intracellular"", ""start_span"": 79, ""end_span"": 92, ""type"": ""Cellular_component""}]"	valid
S - Cdk - dependent phosphorylation of Sld2 essential for chromosomal DNA replication in budding yeast.	chromosomal,58,69,Cellular_component	"[{""token"": ""chromosomal"", ""start_span"": 58, ""end_span"": 69, ""type"": ""Cellular_component""}]"	valid
At the onset of S phase, active S - phase Cdks ( S - Cdks) are essential for chromosomal DNA replication.	chromosomal,77,88,Cellular_component	"[{""token"": ""chromosomal"", ""start_span"": 77, ""end_span"": 88, ""type"": ""Cellular_component""}]"	valid
Here we show that Sld2 ( ref. 4) ( also known as Drc1; ref. 5), one of the replication proteins of budding yeast ( Saccharomyces cerevisiae), is phosphorylated in S phase in an S - Cdk - dependent manner, and mutant Sld2 lacking all the preferred Cdk phosphorylation sites ( All - A) is defective in chromosomal DNA replication.	chromosomal,300,311,Cellular_component	"[{""token"": ""chromosomal"", ""start_span"": 300, ""end_span"": 311, ""type"": ""Cellular_component""}]"	valid
Steps in assembly of silent chromatin in yeast: Sir3 - independent binding of a Sir2 / Sir4 complex to silencers and role for Sir2 - dependent deacetylation.	chromatin,28,37,Cellular_component	"[{""token"": ""chromatin"", ""start_span"": 28, ""end_span"": 37, ""type"": ""Cellular_component""}]"	valid
We further show that the initial binding of the Sir2 / Sir4 complex to DNA sites that nucleate silencing, accompanied by partial Sir2 - dependent histone deacetylation, occurs independently of Sir3 and is likely to be the first step in assembly of silent chromatin at the HM loci and telomeres.	chromatin,255,264,Cellular_component	"[{""token"": ""chromatin"", ""start_span"": 255, ""end_span"": 264, ""type"": ""Cellular_component""}]"	valid
Together, these results support a stepwise model for the assembly of silent chromatin domains in Saccharomyces cerevisiae.	chromatin,76,85,Cellular_component	"[{""token"": ""chromatin"", ""start_span"": 76, ""end_span"": 85, ""type"": ""Cellular_component""}]"	valid
This was accompanied by increased caspase 8 - like and 3 - like activities, nuclear fragmentation and DNA laddering.	nuclear,76,83,Cellular_component	"[{""token"": ""nuclear"", ""start_span"": 76, ""end_span"": 83, ""type"": ""Cellular_component""}]"	valid
LiCl treatment had no effect on IkappaB - alpha degradation, IkappaB kinase ( IKK) activity, NF - kappaB binding activity, and p65 nuclear import and export, but decreased transcription of the NF - kappaB - dependent inducible nitric oxide synthase gene and a NF - kappaB - driven reporter gene.	nuclear,131,138,Cellular_component	"[{""token"": ""nuclear"", ""start_span"": 131, ""end_span"": 138, ""type"": ""Cellular_component""}]"	valid
TOR2 additionally regulates polarization of the actin cytoskeleton in a rapamycin - insensitive manner.	cytoskeleton,54,66,Cellular_component	"[{""token"": ""cytoskeleton"", ""start_span"": 54, ""end_span"": 66, ""type"": ""Cellular_component""}]"	valid
The Toll / interleukin - 1 ( IL - 1) receptor ( TIR) family comprises two groups of transmembrane proteins, which share functional and structural properties.	transmembrane,84,97,Cellular_component	"[{""token"": ""transmembrane"", ""start_span"": 84, ""end_span"": 97, ""type"": ""Cellular_component""}]"	valid
The members of the IL - 1 receptor ( IL - 1R) subfamily are characterized by three extracellular immunoglobulin ( Ig) - like domains.	extracellular,83,96,Cellular_component	"[{""token"": ""extracellular"", ""start_span"": 83, ""end_span"": 96, ""type"": ""Cellular_component""}]"	valid
TLRs possess leucine - rich repeats in their extracellular part.	extracellular,45,58,Cellular_component	"[{""token"": ""extracellular"", ""start_span"": 45, ""end_span"": 58, ""type"": ""Cellular_component""}]"	valid
A hallmark of the TIR family is the cytoplasmic TIR domain that is indispensable for signal transduction.	cytoplasmic,36,47,Cellular_component	"[{""token"": ""cytoplasmic"", ""start_span"": 36, ""end_span"": 47, ""type"": ""Cellular_component""}]"	valid
N - acetylglutamate synthase ( NAGS, E. C. 2. 3. 1. 1) is a mitochondrial enzyme catalyzing the formation of N - acetylglutamate ( NAG), an essential allosteric activator of carbamylphosphate synthase I ( CPSI), the first enzyme of the urea cycle.	mitochondrial,60,73,Cellular_component	"[{""token"": ""mitochondrial"", ""start_span"": 60, ""end_span"": 73, ""type"": ""Cellular_component""}]"	valid
"The deduced amino acid sequence contains an N - terminal putative mitochondrial targeting signal of 49 amino acids ( 63% identity with mouse NAGS) followed by a "" variable domain "" of 45 amino acids ( 35% identity) and a "" conserved domain "" of 440 amino acids ( 92% identity)."	mitochondrial,66,79,Cellular_component	"[{""token"": ""mitochondrial"", ""start_span"": 66, ""end_span"": 79, ""type"": ""Cellular_component""}]"	valid
Nowadays, the importance of additional mechanisms controlling the nuclear transcription potential of NF - kappaB is generally accepted.	nuclear,66,73,Cellular_component	"[{""token"": ""nuclear"", ""start_span"": 66, ""end_span"": 73, ""type"": ""Cellular_component""}]"	valid
Moreover, we identified MSK1 as a nuclear kinase for p65, since MSK1 associates with p65 in a stimulus - dependent way and phosphorylates p65 at Ser276.	nuclear,34,41,Cellular_component	"[{""token"": ""nuclear"", ""start_span"": 34, ""end_span"": 41, ""type"": ""Cellular_component""}]"	valid
Claspin localizes in the nuclei, but it only associates with Chk1 following replication stress or other types of DNA damage.	nuclei,25,31,Cellular_component	"[{""token"": ""nuclei"", ""start_span"": 25, ""end_span"": 31, ""type"": ""Cellular_component""}]"	valid
More importantly, down - regulation of Claspin augments the premature chromatin condensation induced by hydroxyurea, inhibits the UV - induced reduction of DNA synthesis, and decreases cell survival.	chromatin,70,79,Cellular_component	"[{""token"": ""chromatin"", ""start_span"": 70, ""end_span"": 79, ""type"": ""Cellular_component""}]"	valid
In B cells from Cbl - b - deficient mice cross - linking the BCRs resulted in sustained phosphorylation of Igalpha, Syk, and phospholipase C ( PLC) - gamma2, leading to prolonged Ca2 + mobilization, and increases in extracellular signal - regulated kinase ( ERK) and c - Jun NH2 - terminal protein kinase ( JNK) phosphorylation and surface expression of the activation marker, CD69.	surface,332,339,Cellular_component	"[{""token"": ""surface"", ""start_span"": 332, ""end_span"": 339, ""type"": ""Cellular_component""}]"	valid
Following binding its death receptor on the plasma membrane, tumor necrosis factor ( TNF) induces the receptor trimerization and recruits a number of death domain - containing molecules to form the receptor complex.	plasma membrane,44,59,Cellular_component	"[{""token"": ""plasma membrane"", ""start_span"": 44, ""end_span"": 59, ""type"": ""Cellular_component""}]"	valid
IkappaB kinase ( IKK) phosphorylates IkappaBalpha at the residues 32 and 36 followed by polyubiquitination at lysine 21 and 22 and subsequent degradation of the molecules by 26S proteasome.	26S proteasome,174,188,Cellular_component	"[{""token"": ""26S proteasome"", ""start_span"": 174, ""end_span"": 188, ""type"": ""Cellular_component""}]"	valid
However, in midzonal hepatocytes, which constitutively expressed high levels of cytoplasmic MDM2, there was a rapid - onset but transient p53 response.	cytoplasmic,80,91,Cellular_component	"[{""token"": ""cytoplasmic"", ""start_span"": 80, ""end_span"": 91, ""type"": ""Cellular_component""}]"	valid
Rats pre - treated with repeated low or high weekly doses of DEN exhibited EAF and these lesions expressed high levels of cytoplasmic MDM2.	cytoplasmic,122,133,Cellular_component	"[{""token"": ""cytoplasmic"", ""start_span"": 122, ""end_span"": 133, ""type"": ""Cellular_component""}]"	valid
E2F - dependent histone acetylation and recruitment of the Tip60 acetyltransferase complex to chromatin in late G1.	chromatin,94,103,Cellular_component	"[{""token"": ""chromatin"", ""start_span"": 94, ""end_span"": 103, ""type"": ""Cellular_component""}]"	valid
Here, we show that activating E2F species are required for hyperacetylation of target chromatin in human cells.	chromatin,86,95,Cellular_component	"[{""token"": ""chromatin"", ""start_span"": 86, ""end_span"": 95, ""type"": ""Cellular_component""}]"	valid
Moreover, E2F - dependent recruitment of Tip60 to chromatin occurred in late G ( 1) following serum stimulation.	chromatin,50,59,Cellular_component	"[{""token"": ""chromatin"", ""start_span"": 50, ""end_span"": 59, ""type"": ""Cellular_component""}]"	valid
MCM10 and TopBP1 function in the initiation of DNA replication, by regulating the chromatin binding of the DNA polymerase alpha loading factor, CDC45.	chromatin,82,91,Cellular_component	"[{""token"": ""chromatin"", ""start_span"": 82, ""end_span"": 91, ""type"": ""Cellular_component""}]"	valid
We showed, by performing chromatin immunoprecipitation that, in response to UV irradiation but not doxorubicin treatment, E2F4 accumulated on the MCM10 and TopBP1 promoters.	chromatin,25,34,Cellular_component	"[{""token"": ""chromatin"", ""start_span"": 25, ""end_span"": 34, ""type"": ""Cellular_component""}]"	valid
Chromatin immunoprecipitation assays show that in asynchronous cells the p73P1 promoter is occupied predominantly by E2F3; upon tumor necrosis factor ( TNF) - alpha stimulation, E2F3 is dissociated from the promoter and replaced by E2F1.	Chromatin,0,9,Cellular_component	"[{""token"": ""Chromatin"", ""start_span"": 0, ""end_span"": 9, ""type"": ""Cellular_component""}]"	valid
Gel shift assays detected E2F4 binding to a synthetic FGFR1 E2F4 binding site and chromatin immunoprecipitation assays detected E2F4 binding to the endogenous FGFR1 promoter in proliferating myoblasts and myotubes.	chromatin,82,91,Cellular_component	"[{""token"": ""chromatin"", ""start_span"": 82, ""end_span"": 91, ""type"": ""Cellular_component""}]"	valid
The Pkh1 protein kinase of Saccharomyces cerevisiae, a homolog of the mammalian 3 - phosphoinositide - dependent kinase ( PDK1), regulates downstream AGC - type protein kinases including Ypk1 / 2 and Pkc1, which control cell wall integrity, growth, and other processes.	cell wall,220,229,Cellular_component	"[{""token"": ""cell wall"", ""start_span"": 220, ""end_span"": 229, ""type"": ""Cellular_component""}]"	valid
mTOR function in skeletal muscle hypertrophy: increased ribosomal RNA via cell cycle regulators.	ribosomal,56,65,Cellular_component	"[{""token"": ""ribosomal"", ""start_span"": 56, ""end_span"": 65, ""type"": ""Cellular_component""}]"	valid
During myotube hypertrophy, the increase in RNA content was accompanied by an increase in tumor suppressor protein retinoblastoma ( Rb) phosphorylation and a corresponding increase in the availability of the ribosomal DNA transcription factor upstream binding factor ( UBF).	ribosomal,208,217,Cellular_component	"[{""token"": ""ribosomal"", ""start_span"": 208, ""end_span"": 217, ""type"": ""Cellular_component""}]"	valid
Our findings demonstrate that activation of mTOR is necessary for myotube hypertrophy and suggest that the role of mTOR is in part to modulate cyclin D1 - dependent CDK - 4 activity in the regulation of Rb and ribosomal RNA synthesis.	ribosomal,210,219,Cellular_component	"[{""token"": ""ribosomal"", ""start_span"": 210, ""end_span"": 219, ""type"": ""Cellular_component""}]"	valid
Because there are three Fbw7 isoforms that reside in different subcellular compartments, as well as multiple Fbw7 substrates that are the products of proto - oncogenes, the mechanisms of tumor suppression by Fbw7 are complex and incompletely understood.	subcellular compartments,63,87,Cellular_component	"[{""token"": ""subcellular compartments"", ""start_span"": 63, ""end_span"": 87, ""type"": ""Cellular_component""}]"	valid
Here we show a membrane protein named HCP 1 ( heme carrier protein 1), with homology to bacterial metal - tetracycline transporters, mediates heme uptake by cells in a temperature - dependent and saturable manner.	membrane,15,23,Cellular_component	"[{""token"": ""membrane"", ""start_span"": 15, ""end_span"": 23, ""type"": ""Cellular_component""}]"	valid
The Saccharomyces cerevisiae inhibitor of apoptosis ( IAP) repeat protein Bir1 localizes as a chromosomal passenger.	chromosomal,94,105,Cellular_component	"[{""token"": ""chromosomal"", ""start_span"": 94, ""end_span"": 105, ""type"": ""Cellular_component""}]"	valid
The C - terminal region is essential for growth, binds Sli15, and is necessary and sufficient for the localization of Bir1 as a chromosomal passenger.	chromosomal,128,139,Cellular_component	"[{""token"": ""chromosomal"", ""start_span"": 128, ""end_span"": 139, ""type"": ""Cellular_component""}]"	valid
Mutation of all nine CDK consensus sites in the middle region of Bir1 significantly decreased the level of phosphorylation and blocked localization of Ndc10 to the spindle at anaphase.	spindle,164,171,Cellular_component	"[{""token"": ""spindle"", ""start_span"": 164, ""end_span"": 171, ""type"": ""Cellular_component""}]"	valid
Activity of TSC2 is inhibited by AKT - mediated phosphorylation and membrane partitioning.	membrane,68,76,Cellular_component	"[{""token"": ""membrane"", ""start_span"": 68, ""end_span"": 76, ""type"": ""Cellular_component""}]"	valid
We show that hamartin colocalizes with hypophosphorylated tuberin at the membrane, where tuberin exerts its GTPase - activating protein ( GAP) activity to repress Rheb signaling.	membrane,73,81,Cellular_component	"[{""token"": ""membrane"", ""start_span"": 73, ""end_span"": 81, ""type"": ""Cellular_component""}]"	valid
In response to growth signals, tuberin is phosphorylated by AKT and translocates to the cytosol, relieving Rheb repression.	cytosol,88,95,Cellular_component	"[{""token"": ""cytosol"", ""start_span"": 88, ""end_span"": 95, ""type"": ""Cellular_component""}]"	valid
Phosphorylation of tuberin at serines 939 and 981 does not alter its intrinsic GAP activity toward Rheb but partitions tuberin to the cytosol, where it is bound by 14 - 3 - 3 proteins.	cytosol,134,141,Cellular_component	"[{""token"": ""cytosol"", ""start_span"": 134, ""end_span"": 141, ""type"": ""Cellular_component""}]"	valid
Thus, tuberin bound by 14 - 3 - 3 in response to AKT phosphorylation is sequestered away from its membrane - bound activation partner ( hamartin) and its target GTPase ( Rheb) to relieve the growth inhibitory effects of this tumor suppressor.	membrane,98,106,Cellular_component	"[{""token"": ""membrane"", ""start_span"": 98, ""end_span"": 106, ""type"": ""Cellular_component""}]"	valid
These results suggest that STS - induced cerebellar NPC death requires a direct effect of p53 on cytoplasmic apoptotic mediators, whereas genotoxin - induced death requires p53 - dependent gene transcription of PUMA.	cytoplasmic,97,108,Cellular_component	"[{""token"": ""cytoplasmic"", ""start_span"": 97, ""end_span"": 108, ""type"": ""Cellular_component""}]"	valid
Experimental analysis revealed that the membrane - bound osmosensor Sho1 is phosphorylated by Hog1 and that phosphorylation occurs on Ser - 166.	membrane,40,48,Cellular_component	"[{""token"": ""membrane"", ""start_span"": 40, ""end_span"": 48, ""type"": ""Cellular_component""}]"	valid
Eco1 - dependent cohesin acetylation during establishment of sister chromatid cohesion.	sister chromatid,61,77,Cellular_component	"[{""token"": ""sister chromatid"", ""start_span"": 61, ""end_span"": 77, ""type"": ""Cellular_component""}]"	valid
An acetylation - mimicking mutation of a conserved lysine in cohesin ' s Smc3 subunit makes Eco1 dispensable for cell growth, and we show that Smc3 is acetylated in an Eco1 - dependent manner during DNA replication to promote sister chromatid cohesion.	sister chromatid,226,242,Cellular_component	"[{""token"": ""sister chromatid"", ""start_span"": 226, ""end_span"": 242, ""type"": ""Cellular_component""}]"	valid
Our results indicate that Eco1 modifies cohesin to stabilize sister chromatid cohesion in parallel with a cohesion establishment reaction that is in principle Eco1 - independent.	sister chromatid,61,77,Cellular_component	"[{""token"": ""sister chromatid"", ""start_span"": 61, ""end_span"": 77, ""type"": ""Cellular_component""}]"	valid
We found that suppression of NF - kappaB activation by nimbolide was caused by inhibition of IkappaB kinase ( IKK), which led to suppression of IkappaBalpha phosphorylation and degradation, nuclear translocation, DNA binding, and gene transcription.	nuclear,190,197,Cellular_component	"[{""token"": ""nuclear"", ""start_span"": 190, ""end_span"": 197, ""type"": ""Cellular_component""}]"	valid
The phosphorylation and subsequent degradation of I - kappaBalpha as well as the serine 536 phosphorylation and nuclear translocation of p65 NF - kappaB were insufficient for VCAM - 1 expression in response to TNF.	nuclear,112,119,Cellular_component	"[{""token"": ""nuclear"", ""start_span"": 112, ""end_span"": 119, ""type"": ""Cellular_component""}]"	valid
By chromatin immunoprecipitation analysis we identified that increased Zac1 expression is mediated by histone acetylation of the Zac1 promoter region.	chromatin,3,12,Cellular_component	"[{""token"": ""chromatin"", ""start_span"": 3, ""end_span"": 12, ""type"": ""Cellular_component""}]"	valid
Hes1 suppresses expression of Pparg, which encodes the antiinflammatory nuclear receptor Ppargamma.	nuclear,72,79,Cellular_component	"[{""token"": ""nuclear"", ""start_span"": 72, ""end_span"": 79, ""type"": ""Cellular_component""}]"	valid
Increased nuclear localization of beta - catenin and p50 as well as enhanced IKKalpha / AKT interaction were also observed in glioma tissues.	nuclear,10,17,Cellular_component	"[{""token"": ""nuclear"", ""start_span"": 10, ""end_span"": 17, ""type"": ""Cellular_component""}]"	valid
In U87MG cells, the activation of Notch1 by DLL4 stimulation or by the overexpression of Notch intracellular domain ( NICD) resulted in AKT activation and thereby promoted beta - catenin activity and NF - kappaB signaling.	intracellular,95,108,Cellular_component	"[{""token"": ""intracellular"", ""start_span"": 95, ""end_span"": 108, ""type"": ""Cellular_component""}]"	valid
We detected nuclear interaction of these proteins and demonstrated the requirement of all three for FN1 transcription.	nuclear,12,19,Cellular_component	"[{""token"": ""nuclear"", ""start_span"": 12, ""end_span"": 19, ""type"": ""Cellular_component""}]"	valid
DPF3a and DPF3b are additionally shown to interact directly with RelA, p50, and several subunits of the SWI / SNF complex in vitro and to be co - immunoprecipitated with RelA / p50 and the SWI / SNF complex from the nuclear fractions of cells treated with TNF - alpha.	nuclear fractions,216,233,Cellular_component	"[{""token"": ""nuclear fractions"", ""start_span"": 216, ""end_span"": 233, ""type"": ""Cellular_component""}]"	valid
In conclusion, our present data indicate that by linking RelA / p50 to the SWI / SNF complex, DPF3a / b induces the transactivation of NF - kappaB target gene promoters in relatively inactive chromatin contexts.	chromatin,192,201,Cellular_component	"[{""token"": ""chromatin"", ""start_span"": 192, ""end_span"": 201, ""type"": ""Cellular_component""}]"	valid
The results indicated that treatment with oroxylin A inhibited NF - kappaB p65 nuclear translocation and phosphorylation of IkappaBalpha and IKKalpha / beta in both human colon tumor HCT116 cells and human monocytes THP - 1 cells.	nuclear,79,86,Cellular_component	"[{""token"": ""nuclear"", ""start_span"": 79, ""end_span"": 86, ""type"": ""Cellular_component""}]"	valid
Crystal structures of mitochondrial aconitase with alpha - methylisocitrate and with sulfate bound have been solved and refined at 2. 0 A resolution with R factors of 18. 2 and 16. 8%, respectively.	mitochondrial,22,35,Cellular_component	"[{""token"": ""mitochondrial"", ""start_span"": 22, ""end_span"": 35, ""type"": ""Cellular_component""}]"	valid
Cloning, expression, purification, and characterization of the human broad specificity lysosomal acid alpha - mannosidase.	lysosomal,87,96,Cellular_component	"[{""token"": ""lysosomal"", ""start_span"": 87, ""end_span"": 96, ""type"": ""Cellular_component""}]"	valid
We have cloned and expressed two cDNAs encoding the human lysosomal alpha - mannosidase ( EC 3. 2. 1. 24) by RT - PCR of human spleen mRNA.	lysosomal,58,67,Cellular_component	"[{""token"": ""lysosomal"", ""start_span"": 58, ""end_span"": 67, ""type"": ""Cellular_component""}]"	valid
Antiserum raised to the recombinant product of the 3 - kb alpha - mannosidase cDNA immunoprecipitated lysosomal alpha - mannosidase activity from human fibroblast extracts.	lysosomal,102,111,Cellular_component	"[{""token"": ""lysosomal"", ""start_span"": 102, ""end_span"": 111, ""type"": ""Cellular_component""}]"	valid
A novel p53 - inducible gene, PAG608, encodes a nuclear zinc finger protein whose overexpression promotes apoptosis.	nuclear,48,55,Cellular_component	"[{""token"": ""nuclear"", ""start_span"": 48, ""end_span"": 55, ""type"": ""Cellular_component""}]"	valid
Transient overexpression of PAG608 in human tumor - derived cells leads to distinctive changes in nuclear morphology, and can promote apoptosis.	nuclear,98,105,Cellular_component	"[{""token"": ""nuclear"", ""start_span"": 98, ""end_span"": 105, ""type"": ""Cellular_component""}]"	valid
Organic anion transporting polypeptide ( oatp) is an integral membrane protein cloned from rat liver that mediates Na + - independent transport of organic anions such as sulfobromophthalein and taurocholic acid.	membrane,62,70,Cellular_component	"[{""token"": ""membrane"", ""start_span"": 62, ""end_span"": 70, ""type"": ""Cellular_component""}]"	valid
Monolayers grown on glass coverslips were loaded with the pH - sensitive dye 2 ', 7 ' - bis ( carboxyethyl) - 5 ( 6) - carboxyfluorescein; intracellular pH ( pHi) was measured by excitation ratio fluorometry.	intracellular,139,152,Cellular_component	"[{""token"": ""intracellular"", ""start_span"": 139, ""end_span"": 152, ""type"": ""Cellular_component""}]"	valid
In the absence of extracellular Cl - and taurocholate, isohydric reduction of superfusate HCO3 - concentration from 50 to 25 mM resulted in an insignificant change in pHi over time ( dpHi / dt) in both groups.	extracellular,18,31,Cellular_component	"[{""token"": ""extracellular"", ""start_span"": 18, ""end_span"": 31, ""type"": ""Cellular_component""}]"	valid
We show here that TPP - - > TMP conversion can take place in rat liver mitochondria.	mitochondria,71,83,Cellular_component	"[{""token"": ""mitochondria"", ""start_span"": 71, ""end_span"": 83, ""type"": ""Cellular_component""}]"	valid
Additional evidence is given that externally added TMP can cross the mitochondrial membrane in a manner consistent with the occurrence of a carrier - mediated process.	mitochondrial membrane,69,91,Cellular_component	"[{""token"": ""mitochondrial membrane"", ""start_span"": 69, ""end_span"": 91, ""type"": ""Cellular_component""}]"	valid
In a yeast - based screen designed to identify human proteins that interact with human cyclin E, we identified components of the eukaryotic cytosolic chaperonin CCT.	cytosolic,140,149,Cellular_component	"[{""token"": ""cytosolic"", ""start_span"": 140, ""end_span"": 149, ""type"": ""Cellular_component""}]"	valid
Upon binding of a Wnt to its receptor, GSK3beta is inhibited through an unknown mechanism involving Dishevelled ( Dsh), resulting in the dephosphorylation and stabilization of beta - catenin, which translocates to the nucleus and interacts with Lef / Tcf transcription factors to activate target gene expression.	nucleus,218,225,Cellular_component	"[{""token"": ""nucleus"", ""start_span"": 218, ""end_span"": 225, ""type"": ""Cellular_component""}]"	test
Novel inositol polyphosphate 5 - phosphatase localizes at membrane ruffles.	membrane ruffles,58,74,Cellular_component	"[{""token"": ""membrane ruffles"", ""start_span"": 58, ""end_span"": 74, ""type"": ""Cellular_component""}]"	test
We prepared several deletion mutants and demonstrated that the 123 N - terminal amino acids ( 311 - 433) and a C - terminal proline - rich region containing 277 amino acids ( 725 - 1001) were essential for its localization to ruffling membranes.	ruffling membranes,226,244,Cellular_component	"[{""token"": ""ruffling membranes"", ""start_span"": 226, ""end_span"": 244, ""type"": ""Cellular_component""}]"	test
This enzyme might regulate the level of inositol and phosphatidylinositol polyphosphates at membrane ruffles.	membrane ruffles,92,108,Cellular_component	"[{""token"": ""membrane ruffles"", ""start_span"": 92, ""end_span"": 108, ""type"": ""Cellular_component""}]"	test
In nonstimulated cells, NF - kappa B dimers are maintained in the cytoplasm through interaction with inhibitory proteins, the I kappa Bs.	cytoplasm,66,75,Cellular_component	"[{""token"": ""cytoplasm"", ""start_span"": 66, ""end_span"": 75, ""type"": ""Cellular_component""}]"	test
Phosphorylated I kappa Bs are recognized by a specific E3 ubiquitin ligase complex and undergo polyubiquitination which targets them for rapid degradation by the 26S proteasome.	26S proteasome,162,176,Cellular_component	"[{""token"": ""26S proteasome"", ""start_span"": 162, ""end_span"": 176, ""type"": ""Cellular_component""}]"	test
NF - kappa B dimers, which are spared from degradation, translocate to the nucleus to activate gene transcription.	nucleus,75,82,Cellular_component	"[{""token"": ""nucleus"", ""start_span"": 75, ""end_span"": 82, ""type"": ""Cellular_component""}]"	test
Except for the OVCA3 cell line, Western blot analysis of the nuclear extracts prepared from the cell lines showed concordant levels of p73 protein.	nuclear,61,68,Cellular_component	"[{""token"": ""nuclear"", ""start_span"": 61, ""end_span"": 68, ""type"": ""Cellular_component""}]"	test
Insulin induces a change in the intracellular localization of this protein, which translates into increased glucose uptake into the blastocyst, a process that is inhibited by antisense oligoprobes.	intracellular,32,45,Cellular_component	"[{""token"": ""intracellular"", ""start_span"": 32, ""end_span"": 45, ""type"": ""Cellular_component""}]"	test
The early steps leading to NF - kappaB activation ( degradation of I - kappaB and translocation of NF - kappaB to the nucleus) were unaffected by the loss of GSK - 3beta, indicating that NF - kappaB is regulated by GSK - 3beta at the level of the transcriptional complex.	nucleus,118,125,Cellular_component	"[{""token"": ""nucleus"", ""start_span"": 118, ""end_span"": 125, ""type"": ""Cellular_component""}]"	test
This study demonstrates that both JNK and p38 intracellular signalling cascades are robustly, yet transiently increased following prolonged running exercise.	intracellular,46,59,Cellular_component	"[{""token"": ""intracellular"", ""start_span"": 46, ""end_span"": 59, ""type"": ""Cellular_component""}]"	test
The p21 - activated kinases ( PAKs), stimulated by binding with GTP - liganded forms of Cdc42 or Rac, modulate cytoskeletal actin assembly and activate MAP - kinase pathways.	cytoskeletal,111,123,Cellular_component	"[{""token"": ""cytoskeletal"", ""start_span"": 111, ""end_span"": 123, ""type"": ""Cellular_component""}]"	test
Blockade of this polyubiquitin chain synthesis, but not inhibition of the proteasome, prevents the activation of IKK by TRAF6.	proteasome,74,84,Cellular_component	"[{""token"": ""proteasome"", ""start_span"": 74, ""end_span"": 84, ""type"": ""Cellular_component""}]"	test
During inflammation the balance between cell activation and cell death is determined by the tight regulation of multiple intracellular enzyme cascades.	intracellular,121,134,Cellular_component	"[{""token"": ""intracellular"", ""start_span"": 121, ""end_span"": 134, ""type"": ""Cellular_component""}]"	test
Thus TAK1 must be considered as an important component of intracellular pathways in cells involved in host responses to physiological and / or environmental stress signals during inflammation.	intracellular,58,71,Cellular_component	"[{""token"": ""intracellular"", ""start_span"": 58, ""end_span"": 71, ""type"": ""Cellular_component""}]"	test
Cloning, Golgi localization, and enzyme activity of the full - length heparin / heparan sulfate - glucuronic acid C5 - epimerase.	Golgi,9,14,Cellular_component	"[{""token"": ""Golgi"", ""start_span"": 9, ""end_span"": 14, ""type"": ""Cellular_component""}]"	test
The target of Tat appeared to be adenylyl cyclase, whose activity was markedly reduced ( up to 60%) in membranes prepared from Tat - treated microglial cells, both in basal conditions and after stimulation with isoproterenol and forskolin.	membranes,103,112,Cellular_component	"[{""token"": ""membranes"", ""start_span"": 103, ""end_span"": 112, ""type"": ""Cellular_component""}]"	test
On the contrary, two inhibitors of nuclear factor kappaB activation, N - tosyl - ( L) - phenylalanine chloromethyl ketone ( 10 microM) and SN50 ( 25 microM), markedly prevented the reduction of forskolin - evoked cAMP accumulation by Tat, suggesting a possible role for this nuclear transcriptional factor in the regulation of adenylyl cyclase by Tat in microglia.	nuclear,35,42,Cellular_component	"[{""token"": ""nuclear"", ""start_span"": 35, ""end_span"": 42, ""type"": ""Cellular_component""}]"	test
A subclone of the human B lymphoma cell line BJA - B K20, lacking UDP - N - acetylglucosamine 2 - epimerase / N - acetylmannosamine kinase mRNA as well as epimerase activity, displayed hyposialylated, functionally impaired cell surface glycoconjugates.	cell surface,223,235,Cellular_component	"[{""token"": ""cell surface"", ""start_span"": 223, ""end_span"": 235, ""type"": ""Cellular_component""}]"	test
The CMP - N - acetylneuraminic acid content of both K88 and K20 cells and the sialylation of cell surface glycoconjugates of K20 cells could be significantly increased by supplementing the medium with N - acetylmannosamine.	cell surface,93,105,Cellular_component	"[{""token"": ""cell surface"", ""start_span"": 93, ""end_span"": 105, ""type"": ""Cellular_component""}]"	test
The yeast transcription factors Ace2p and Swi5p regulate the expression of several target genes involved in mating type switching, exit from mitosis and cell wall function.	cell wall,153,162,Cellular_component	"[{""token"": ""cell wall"", ""start_span"": 153, ""end_span"": 162, ""type"": ""Cellular_component""}]"	test
Like Cts1p and Scw11p, the two new Ace2p targets are associated with cell wall metabolism.	cell wall,69,78,Cellular_component	"[{""token"": ""cell wall"", ""start_span"": 69, ""end_span"": 78, ""type"": ""Cellular_component""}]"	test
Yhr143p is localized to the cell wall, and deletion affects cell separation and enhances pseudohyphal growth.	cell wall,28,37,Cellular_component	"[{""token"": ""cell wall"", ""start_span"": 28, ""end_span"": 37, ""type"": ""Cellular_component""}]"	test
Deleting YER124C also affects cell separation and sensitivity to drugs targeted against the cell wall.	cell wall,92,101,Cellular_component	"[{""token"": ""cell wall"", ""start_span"": 92, ""end_span"": 101, ""type"": ""Cellular_component""}]"	test
In mammalian germ cells, cAMP signaling is dependent on two forms of adenylyl cyclase, the conventional membrane - bound ACIII and a soluble form of adenylyl cyclase ( sAC).	membrane,104,112,Cellular_component	"[{""token"": ""membrane"", ""start_span"": 104, ""end_span"": 112, ""type"": ""Cellular_component""}]"	test
Recent elucidation of the sAC sequence indicates that this enzyme is phylogenetically distinct from the membrane - bound AC, does not interact with G proteins, and its activity is regulated by bicarbonate ions.	membrane,104,112,Cellular_component	"[{""token"": ""membrane"", ""start_span"": 104, ""end_span"": 112, ""type"": ""Cellular_component""}]"	test
Functional analysis of the hydrophobic patch on nuclear transport factor 2 involved in interactions with the nuclear pore in vivo.	nuclear pore,109,121,Cellular_component	"[{""token"": ""nuclear pore"", ""start_span"": 109, ""end_span"": 121, ""type"": ""Cellular_component""}]"	test
The interaction between NTF2 and Ran is essential for the import of Ran into the nucleus.	nucleus,81,88,Cellular_component	"[{""token"": ""nucleus"", ""start_span"": 81, ""end_span"": 88, ""type"": ""Cellular_component""}]"	test
Here we have tested this hypothesis directly by using formaldehyde cross - linked chromatin immunoprecipitation ( XChIP) assays to evaluate HDAC association in living cells.	chromatin,82,91,Cellular_component	"[{""token"": ""chromatin"", ""start_span"": 82, ""end_span"": 91, ""type"": ""Cellular_component""}]"	test
Gene expression assays and chromatin immunoprecipitation experiments revealed Slt2 - dependent recruitment of SBF to the promoters of the G ( 1) cyclins PCL1 and PCL2 after activation of the Slt2 - MAPK pathway.	chromatin,27,36,Cellular_component	"[{""token"": ""chromatin"", ""start_span"": 27, ""end_span"": 36, ""type"": ""Cellular_component""}]"	test
APC ( Cdc20) promotes sister - chromatid separation by ubiquitinating securin, whereas APC ( Cdh1) ubiquitinates mitotic cyclins, allowing the exit from mitosis.	sister - chromatid,22,40,Cellular_component	"[{""token"": ""sister - chromatid"", ""start_span"": 22, ""end_span"": 40, ""type"": ""Cellular_component""}]"	test
hCdc14a is a major phosphatase for hCdh1 and localizes to centrosomes in HeLa cells.	centrosomes,58,69,Cellular_component	"[{""token"": ""centrosomes"", ""start_span"": 58, ""end_span"": 69, ""type"": ""Cellular_component""}]"	test
Physiological substrates for human lysosomal beta - hexosaminidase S.	lysosomal,35,44,Cellular_component	"[{""token"": ""lysosomal"", ""start_span"": 35, ""end_span"": 44, ""type"": ""Cellular_component""}]"	test
Human lysosomal beta - hexosaminidases remove terminal beta - glycosidically bound N - acetylhexosamine residues from a number of glycoconjugates.	lysosomal,6,15,Cellular_component	"[{""token"": ""lysosomal"", ""start_span"": 6, ""end_span"": 15, ""type"": ""Cellular_component""}]"	test
C - TAK1 constitutively associates with mammalian KSR1 and phosphorylates serine 392 to confer 14 - 3 - 3 binding and cytoplasmic sequestration of KSR1 in unstimulated cells.	cytoplasmic,118,129,Cellular_component	"[{""token"": ""cytoplasmic"", ""start_span"": 118, ""end_span"": 129, ""type"": ""Cellular_component""}]"	test
In response to signal activation, the phosphorylation state of S392 is reduced, allowing the KSR1 complex to colocalize with activated Ras and Raf - 1 at the plasma membrane, thereby facilitating the phosphorylation reactions required for the activation of MEK and MAPK.	plasma membrane,158,173,Cellular_component	"[{""token"": ""plasma membrane"", ""start_span"": 158, ""end_span"": 173, ""type"": ""Cellular_component""}]"	test
Furthermore, a TIP41 deletion prevents SIT4 - dependent events such as dephosphorylation of the kinase NPR1 and nuclear translocation of the transcription factor GLN3.	nuclear,112,119,Cellular_component	"[{""token"": ""nuclear"", ""start_span"": 112, ""end_span"": 119, ""type"": ""Cellular_component""}]"	test
Here we report the isolation of the major E3RS - associated protein, hnRNP - U, an abundant nuclear phosphoprotein.	nuclear,92,99,Cellular_component	"[{""token"": ""nuclear"", ""start_span"": 92, ""end_span"": 99, ""type"": ""Cellular_component""}]"	test
This protein occupies E3RS in a specific and stoichiometric manner, stabilizes the E3 component, and is likely responsible for its nuclear localization.	nuclear,131,138,Cellular_component	"[{""token"": ""nuclear"", ""start_span"": 131, ""end_span"": 138, ""type"": ""Cellular_component""}]"	test
Frizzled proteins and lipoprotein - receptor - related proteins 5 and 6 ( LRP5 / 6) bind Wnts and transmit their signal by stabilizing intracellular beta - catenin.	intracellular,135,148,Cellular_component	"[{""token"": ""intracellular"", ""start_span"": 135, ""end_span"": 148, ""type"": ""Cellular_component""}]"	test
Kremen2 forms a ternary complex with Dkk1 and LRP6, and induces rapid endocytosis and removal of the Wnt receptor LRP6 from the plasma membrane.	plasma membrane,128,143,Cellular_component	"[{""token"": ""plasma membrane"", ""start_span"": 128, ""end_span"": 143, ""type"": ""Cellular_component""}]"	test
The results indicate that Kremen1 and Kremen2 are components of a membrane complex modulating canonical Wnt signalling through LRP6 in vertebrates.	membrane,66,74,Cellular_component	"[{""token"": ""membrane"", ""start_span"": 66, ""end_span"": 74, ""type"": ""Cellular_component""}]"	test
E2F - 1 enhanced the expression of Apaf - 1 without the cytosolic accumulation of cytochrome c.	cytosolic,56,65,Cellular_component	"[{""token"": ""cytosolic"", ""start_span"": 56, ""end_span"": 65, ""type"": ""Cellular_component""}]"	test
A chromatin immunoprecipitation assay revealed that E2F - 1 bound to Apaf - 1 promoter upon E2F - 1 overexpression, suggesting that Apaf - 1 is under transcriptional regulation of E2F - 1.	chromatin,2,11,Cellular_component	"[{""token"": ""chromatin"", ""start_span"": 2, ""end_span"": 11, ""type"": ""Cellular_component""}]"	test
These data demonstrate a novel mechanism of apoptosis in which an increase in Apaf - 1 levels results in direct activation of caspase - 9 without mitochondrial damage, leading to the initiation of a caspase cascade.	mitochondrial,146,159,Cellular_component	"[{""token"": ""mitochondrial"", ""start_span"": 146, ""end_span"": 159, ""type"": ""Cellular_component""}]"	test
The ubiquitin system has been recently implicated in various aspects of transcriptional regulation, including proteasome - dependent degradation of transcriptional activators.	proteasome,110,120,Cellular_component	"[{""token"": ""proteasome"", ""start_span"": 110, ""end_span"": 120, ""type"": ""Cellular_component""}]"	test
The INK4a - ARF locus, located on chromosome 9p21, encodes two cell - cycle regulatory proteins, p16 ( INK4a) and p14 ( ARF), acting through the Rb - CDK4 and p53 pathways.	chromosome,34,44,Cellular_component	"[{""token"": ""chromosome"", ""start_span"": 34, ""end_span"": 44, ""type"": ""Cellular_component""}]"	test
I - kappa B kinase ( IKK) is a serine / threonine kinase that phosphorylates I - kappa B alpha and I - kappa B beta and targets them for polyubiquitination and proteasome - mediated degradation.	proteasome,160,170,Cellular_component	"[{""token"": ""proteasome"", ""start_span"": 160, ""end_span"": 170, ""type"": ""Cellular_component""}]"	test
Furthermore, genotoxic stress increases the levels of nuclear E2F - 4 and p130 as well as their in vivo binding to the Stathmin promoter.	nuclear,54,61,Cellular_component	"[{""token"": ""nuclear"", ""start_span"": 54, ""end_span"": 61, ""type"": ""Cellular_component""}]"	test
Cell cycle - dependent nuclear export of Cdh1p may contribute to the inactivation of APC / C ( Cdh1).	nuclear,23,30,Cellular_component	"[{""token"": ""nuclear"", ""start_span"": 23, ""end_span"": 30, ""type"": ""Cellular_component""}]"	test
Nuclear export of Cdh1p is regulated by phosphorylation and requires active Cdc28p kinase.	Nuclear,0,7,Cellular_component	"[{""token"": ""Nuclear"", ""start_span"": 0, ""end_span"": 7, ""type"": ""Cellular_component""}]"	test
Likewise, a mutant form of Cdh1p, which is constitutively nuclear, prevents accumulation of Clb2p and leads to cell cycle arrest when overexpressed in wild - type cells.	nuclear,58,65,Cellular_component	"[{""token"": ""nuclear"", ""start_span"": 58, ""end_span"": 65, ""type"": ""Cellular_component""}]"	test
Taken together, these results suggest that phosphorylation - dependent nuclear export of Cdh1p by Msn5p contributes to efficient inactivation of APC / C ( Cdh1).	nuclear,71,78,Cellular_component	"[{""token"": ""nuclear"", ""start_span"": 71, ""end_span"": 78, ""type"": ""Cellular_component""}]"	test
Nijmegen breakage syndrome ( NBS) is an autosomal recessive disorder characterized by microcephaly, chromosomal instability, radiation sensitivity, and an increased incidence of malignancies.	chromosomal,100,111,Cellular_component	"[{""token"": ""chromosomal"", ""start_span"": 100, ""end_span"": 111, ""type"": ""Cellular_component""}]"	test
Here, we show that a BRCA carboxyl terminus ( BRCT) domain - containing region of NBS1 interacts with a nuclear dots - associated protein, SP100.	nuclear dots,104,116,Cellular_component	"[{""token"": ""nuclear dots"", ""start_span"": 104, ""end_span"": 116, ""type"": ""Cellular_component""}]"	test
Introduction of PML and SP100 into NT2 cells, which express no detectable amount of PML or SP100 proteins, resulted in localization of NBS1 in ectopically expressed PODs.	PODs,165,169,Cellular_component	"[{""token"": ""PODs"", ""start_span"": 165, ""end_span"": 169, ""type"": ""Cellular_component""}]"	test
These results indicate that NBS1 is recruited into PODs via interaction with SP100 protein.	PODs,51,55,Cellular_component	"[{""token"": ""PODs"", ""start_span"": 51, ""end_span"": 55, ""type"": ""Cellular_component""}]"	test
The activation of Cdk1 participates also in HIV - 1 - induced apoptosis, upstream of the p53 - dependent mitochondrial permeabilization step.	mitochondrial,105,118,Cellular_component	"[{""token"": ""mitochondrial"", ""start_span"": 105, ""end_span"": 118, ""type"": ""Cellular_component""}]"	test
NF - kappaB1 p105 functions both as a precursor of NF - kappaB1 p50 and as a cytoplasmic inhibitor of NF - kappaB.	cytoplasmic,77,88,Cellular_component	"[{""token"": ""cytoplasmic"", ""start_span"": 77, ""end_span"": 88, ""type"": ""Cellular_component""}]"	test
This phosphorylation is essential for TNF - alpha to trigger p105 degradation, which releases the associated Rel / NF - kappaB subunits to translocate into the nucleus and regulate target gene transcription.	nucleus,160,167,Cellular_component	"[{""token"": ""nucleus"", ""start_span"": 160, ""end_span"": 167, ""type"": ""Cellular_component""}]"	test
Wnt signaling induces the stabilization of cytosolic beta - catenin, which then associates with lymphoid enhancer factor and T - cell factor ( LEF - 1 / TCF) to form a transcription complex that activates Wnt target genes.	cytosolic,43,52,Cellular_component	"[{""token"": ""cytosolic"", ""start_span"": 43, ""end_span"": 52, ""type"": ""Cellular_component""}]"	test
Chromatin immunoprecipitation assays showed that TFE3 and E2F3 were bound to the p68 promoter in vivo and that the interaction of either E2F3 or TFE3 with the promoter was facilitated by the presence of both proteins.	Chromatin,0,9,Cellular_component	"[{""token"": ""Chromatin"", ""start_span"": 0, ""end_span"": 9, ""type"": ""Cellular_component""}]"	test
Therefore, we used a combination of chromatin immunoprecipitation and genomic microarrays to identify promoters bound by E2F6 in human cells.	chromatin,36,45,Cellular_component	"[{""token"": ""chromatin"", ""start_span"": 36, ""end_span"": 45, ""type"": ""Cellular_component""}]"	test
Interestingly, many of the E2F6 - regulated genes encoded functions involved in tumor suppression and the maintenance of chromatin structure.	chromatin,121,130,Cellular_component	"[{""token"": ""chromatin"", ""start_span"": 121, ""end_span"": 130, ""type"": ""Cellular_component""}]"	test
To determine the mechanism by which E2F6 regulates transcription, we performed chromatin immunoprecipitation before and after the introduction of small inhibitory ribonucleic acids specific to E2F6.	chromatin,79,88,Cellular_component	"[{""token"": ""chromatin"", ""start_span"": 79, ""end_span"": 88, ""type"": ""Cellular_component""}]"	test
Recruitment of Cdc28 by Whi3 restricts nuclear accumulation of the G1 cyclin - Cdk complex to late G1.	nuclear,39,46,Cellular_component	"[{""token"": ""nuclear"", ""start_span"": 39, ""end_span"": 46, ""type"": ""Cellular_component""}]"	test
Efficient interaction with Cdc28 depends on an N - terminal domain of Whi3 that is also required for cytoplasmic localization of Cdc28, and for proper regulation of G1 length and filamentous growth.	cytoplasmic,101,112,Cellular_component	"[{""token"": ""cytoplasmic"", ""start_span"": 101, ""end_span"": 112, ""type"": ""Cellular_component""}]"	test
However, Whi3 - deficient cells show a distinct nuclear accumulation of Cln3 and Cdc28 already in early G1.	nuclear,48,55,Cellular_component	"[{""token"": ""nuclear"", ""start_span"": 48, ""end_span"": 55, ""type"": ""Cellular_component""}]"	test
We propose that Whi3 constitutes a cytoplasmic retention device for Cln3 - Cdc28 complexes, thus defining a key G1 event in yeast cells.	cytoplasmic,35,46,Cellular_component	"[{""token"": ""cytoplasmic"", ""start_span"": 35, ""end_span"": 46, ""type"": ""Cellular_component""}]"	test
The transcription factor NF - kappaB is activated by the degradation of its inhibitor IkappaBalpha, resulting in its nuclear translocation.	nuclear,117,124,Cellular_component	"[{""token"": ""nuclear"", ""start_span"": 117, ""end_span"": 124, ""type"": ""Cellular_component""}]"	test
However, the mechanism by which nuclear NF - kappaB is subsequently regulated is not clear.	nuclear,32,39,Cellular_component	"[{""token"": ""nuclear"", ""start_span"": 32, ""end_span"": 39, ""type"": ""Cellular_component""}]"	test
Upon cytokine treatment, Pin1 binds to the pThr254 - Pro motif in p65 and inhibits p65 binding to IkappaBalpha, resulting in increased nuclear accumulation and protein stability of p65 and enhanced NF - kappaB activity.	nuclear,135,142,Cellular_component	"[{""token"": ""nuclear"", ""start_span"": 135, ""end_span"": 142, ""type"": ""Cellular_component""}]"	test
In cycling cells, transcription of ribosomal RNA genes by RNA polymerase I ( Pol I) is tightly coordinated with cell growth.	ribosomal,35,44,Cellular_component	"[{""token"": ""ribosomal"", ""start_span"": 35, ""end_span"": 44, ""type"": ""Cellular_component""}]"	test
Moreover, rapamycin treatment leads to translocation of TIF - IA into the cytoplasm.	cytoplasm,74,83,Cellular_component	"[{""token"": ""cytoplasm"", ""start_span"": 74, ""end_span"": 83, ""type"": ""Cellular_component""}]"	test
Swe1 is recruited to the neck and hyperphosphorylated before ubiquitin - mediated degradation.	neck,25,29,Cellular_component	"[{""token"": ""neck"", ""start_span"": 25, ""end_span"": 29, ""type"": ""Cellular_component""}]"	test
Hsl1 kinase ( Nim1 ortholog), a negative regulator of Wee1, is required for efficient Swe1 localization at the neck but seems not to phosphorylate Swe1.	neck,111,115,Cellular_component	"[{""token"": ""neck"", ""start_span"": 111, ""end_span"": 115, ""type"": ""Cellular_component""}]"	test
Here, we show that two other kinases targeted sequentially to the neck, Cla4 / PAK and Cdc5 / Polo, are responsible for stepwise phosphorylation and down - regulation of Swe1.	neck,66,70,Cellular_component	"[{""token"": ""neck"", ""start_span"": 66, ""end_span"": 70, ""type"": ""Cellular_component""}]"	test
This mechanism links assembly of a cellular structure to passage into mitosis.	cellular structure,35,53,Cellular_component	"[{""token"": ""cellular structure"", ""start_span"": 35, ""end_span"": 53, ""type"": ""Cellular_component""}]"	test
HFRC1 was localized within the Golgi apparatus following its transient expression in HCT116 cells.	Golgi apparatus,31,46,Cellular_component	"[{""token"": ""Golgi apparatus"", ""start_span"": 31, ""end_span"": 46, ""type"": ""Cellular_component""}]"	test
Overexpression of the hfrc1 gene in HCT116 cells modulated the cell surface heparan sulfate expression status.	cell surface,63,75,Cellular_component	"[{""token"": ""cell surface"", ""start_span"": 63, ""end_span"": 75, ""type"": ""Cellular_component""}]"	test
RB pathway activation resulted in the repression of Plk1 promoter activity, and this action was dependent on the SWI / SNF chromatin remodeling complex.	chromatin,123,132,Cellular_component	"[{""token"": ""chromatin"", ""start_span"": 123, ""end_span"": 132, ""type"": ""Cellular_component""}]"	test
beta - D - Glucoside suppresses tumor necrosis factor - induced activation of nuclear transcription factor kappaB but potentiates apoptosis.	nuclear,78,85,Cellular_component	"[{""token"": ""nuclear"", ""start_span"": 78, ""end_span"": 85, ""type"": ""Cellular_component""}]"	test
In addition, mangiferin inhibits TNF - induced p65 phosphorylation as well as translocation to the nucleus and also inhibits NF - kappaB activation induced by other inflammatory agents like PMA, ceramide, and SA - LPS.	nucleus,99,106,Cellular_component	"[{""token"": ""nucleus"", ""start_span"": 99, ""end_span"": 106, ""type"": ""Cellular_component""}]"	test
Since intracellular glutathione ( GSH) levels are known to modulate NF - kappaB levels, we measured the levels of GSH.	intracellular,6,19,Cellular_component	"[{""token"": ""intracellular"", ""start_span"": 6, ""end_span"": 19, ""type"": ""Cellular_component""}]"	test
Hence mangiferin with its ability to inhibit NF - kappaB and increase the intracellular GSH levels may prove to be a potent drug for anti - inflammatory and antioxidant therapy.	intracellular,74,87,Cellular_component	"[{""token"": ""intracellular"", ""start_span"": 74, ""end_span"": 87, ""type"": ""Cellular_component""}]"	test
E2F4 protein levels increased and accumulated in the nuclei of prostate carcinoma cells subjected to ionizing radiation ( IR).	nuclei,53,59,Cellular_component	"[{""token"": ""nuclei"", ""start_span"": 53, ""end_span"": 59, ""type"": ""Cellular_component""}]"	test
Disruption of E2F4 through small interfering RNA prevented p130 / E2F4 complex formation and sensitized cells to IR - induced apoptosis, leading to caspase - 3 activation, cleavage of its substrate, poly ( ADP - ribose) polymerase, and nuclear condensation.	nuclear,236,243,Cellular_component	"[{""token"": ""nuclear"", ""start_span"": 236, ""end_span"": 243, ""type"": ""Cellular_component""}]"	test
Regulation of Toll / IL - 1 - receptor - mediated gene expression by the inducible nuclear protein IkappaBzeta.	nuclear,83,90,Cellular_component	"[{""token"": ""nuclear"", ""start_span"": 83, ""end_span"": 90, ""type"": ""Cellular_component""}]"	test
IkappaBzeta ( also known as MAIL and INAP) is an ankyrin - repeat - containing nuclear protein that is highly homologous to the IkappaB family member Bcl - 3 ( refs 1 - 6).	nuclear,79,86,Cellular_component	"[{""token"": ""nuclear"", ""start_span"": 79, ""end_span"": 86, ""type"": ""Cellular_component""}]"	test
Phosphorylation by cyclin B - Cdk underlies release of mitotic exit activator Cdc14 from the nucleolus.	nucleolus,93,102,Cellular_component	"[{""token"": ""nucleolus"", ""start_span"": 93, ""end_span"": 102, ""type"": ""Cellular_component""}]"	test
Budding yeast protein phosphatase Cdc14 is sequestered in the nucleolus in an inactive state during interphase by the anchor protein Net1.	nucleolus,62,71,Cellular_component	"[{""token"": ""nucleolus"", ""start_span"": 62, ""end_span"": 71, ""type"": ""Cellular_component""}]"	test
We also summarize the roles of mTOR in the control of cell growth and proliferation, as well as its relevance to cancer and synaptic plasticity.	synaptic,124,132,Cellular_component	"[{""token"": ""synaptic"", ""start_span"": 124, ""end_span"": 132, ""type"": ""Cellular_component""}]"	test
TLR3 signaling activates the transcription factor IRF - 3 by its Ser / Thr phosphorylation, accompanied by its dimerization and nuclear translocation.	nuclear,128,135,Cellular_component	"[{""token"": ""nuclear"", ""start_span"": 128, ""end_span"": 135, ""type"": ""Cellular_component""}]"	test
Glycosylphosphatidylinositol ( GPI) is a glycolipid that anchors many proteins to the eukaryotic cell surface.	cell surface,97,109,Cellular_component	"[{""token"": ""cell surface"", ""start_span"": 97, ""end_span"": 109, ""type"": ""Cellular_component""}]"	test
PIG - V has two functionally important conserved regions facing the ER lumen.	ER lumen,68,76,Cellular_component	"[{""token"": ""ER lumen"", ""start_span"": 68, ""end_span"": 76, ""type"": ""Cellular_component""}]"	test
The results have revealed that Hsf1 is necessary for heat - induced transcription of not only HSP but also genes encoding proteins involved in diverse cellular processes such as protein degradation, detoxification, energy generation, carbohydrate metabolism, and maintenance of cell wall integrity.	cell wall,278,287,Cellular_component	"[{""token"": ""cell wall"", ""start_span"": 278, ""end_span"": 287, ""type"": ""Cellular_component""}]"	test
NF - { kappa} B is transported into the nucleus by importin { alpha} 3 and importin { alpha} 4.	nucleus,40,47,Cellular_component	"[{""token"": ""nucleus"", ""start_span"": 40, ""end_span"": 47, ""type"": ""Cellular_component""}]"	test
We identified importin alpha3 and importin alpha4 as the main importin alpha isoforms mediating TNF - alpha - stimulated NF - kappaB p50 / p65 heterodimer translocation into the nucleus.	nucleus,178,185,Cellular_component	"[{""token"": ""nucleus"", ""start_span"": 178, ""end_span"": 185, ""type"": ""Cellular_component""}]"	test
We show that importin alpha3 isoform also mediates nuclear import of NF - kappaB p50 homodimer in nonstimulated cells.	nuclear,51,58,Cellular_component	"[{""token"": ""nuclear"", ""start_span"": 51, ""end_span"": 58, ""type"": ""Cellular_component""}]"	test
Importin alpha3 is shown to directly bind to previously characterized nuclear localization signals ( NLSs) of NF - kappaB p50 and p65 proteins.	nuclear,70,77,Cellular_component	"[{""token"": ""nuclear"", ""start_span"": 70, ""end_span"": 77, ""type"": ""Cellular_component""}]"	test
The present study demonstrates that the nuclear import of NF - kappaB is a highly regulated process mediated by a subset of importin alpha molecules.	nuclear,40,47,Cellular_component	"[{""token"": ""nuclear"", ""start_span"": 40, ""end_span"": 47, ""type"": ""Cellular_component""}]"	test
Regulation of neuron survival and death by p130 and associated chromatin modifiers.	chromatin,63,72,Cellular_component	"[{""token"": ""chromatin"", ""start_span"": 63, ""end_span"": 72, ""type"": ""Cellular_component""}]"	test
Here we show that p130 is the predominant Rb family member associated with E2F in neurons, that its major partner for repression of pro - apoptotic genes is E2F4, and that the p130 - E2F4 complex recruits the chromatin modifiers HDAC1 and Suv39H1 to promote gene silencing and neuron survival.	chromatin,209,218,Cellular_component	"[{""token"": ""chromatin"", ""start_span"": 209, ""end_span"": 218, ""type"": ""Cellular_component""}]"	test
Experimental suppression of such events blocks neuron death while interference with the synthesis of E2F4 or p130, or with the interaction of E2F4 - p130 with chromatin modifiers, induces neuron death.	chromatin,159,168,Cellular_component	"[{""token"": ""chromatin"", ""start_span"": 159, ""end_span"": 168, ""type"": ""Cellular_component""}]"	test
Consistently, we demonstrate by chromatin immunoprecipitation assays that endogenous E2F1 is recruited to the H19 promoter in vivo.	chromatin,32,41,Cellular_component	"[{""token"": ""chromatin"", ""start_span"": 32, ""end_span"": 41, ""type"": ""Cellular_component""}]"	test
However, chromatin immunoprecipitation assays demonstrate that PTEN differentially reduces the occupancy of the SL1 subunits on the rRNA gene promoter.	chromatin,9,18,Cellular_component	"[{""token"": ""chromatin"", ""start_span"": 9, ""end_span"": 18, ""type"": ""Cellular_component""}]"	test
Using genome - wide chromatin immunoprecipitation, we show that there are distinct classes of genes directly regulated by unique combinations of E2F4, p107, and p130, including a group of genes specifically regulated in cycling cells.	chromatin,20,29,Cellular_component	"[{""token"": ""chromatin"", ""start_span"": 20, ""end_span"": 29, ""type"": ""Cellular_component""}]"	test
We investigated the potential role of Salmonella enterica serotype Typhimurium fimbriae as pathogen - associated molecular patterns ( PAMPs) that may stimulate innate pathways of inflammation.	fimbriae,79,87,Cellular_component	"[{""token"": ""fimbriae"", ""start_span"": 79, ""end_span"": 87, ""type"": ""Cellular_component""}]"	test
The mechanism by which thin curled fimbriae encoded by the csg genes contribute to inflammation was further investigated using tissue culture.	thin curled fimbriae,23,43,Cellular_component	"[{""token"": ""thin curled fimbriae"", ""start_span"": 23, ""end_span"": 43, ""type"": ""Cellular_component""}]"	test
Purified thin curled fimbriae induced IL - 8 expression in human embryonic kidney ( HEK293) cells transfected with Toll - like receptor ( TLR) 2 / CD14 but not in cells transfected with TLR5, TLR4 / MD2 / CD14 or TLR11.	thin curled fimbriae,9,29,Cellular_component	"[{""token"": ""thin curled fimbriae"", ""start_span"": 9, ""end_span"": 29, ""type"": ""Cellular_component""}]"	test
Fusion proteins between the major fimbrial subunit of thin curled fimbriae ( CsgA) and glutathione - S - transferase ( GST) elicited IL - 8 production in HEK293 cells transfected with TLR2 / CD14.	thin curled fimbriae,54,74,Cellular_component	"[{""token"": ""thin curled fimbriae"", ""start_span"": 54, ""end_span"": 74, ""type"": ""Cellular_component""}]"	test
Thirdly, and critically, MA also inhibits Hdm2 synthesis at the post - transcriptional level, with negative effects on hdm2 mRNA nuclear export and translation.	nuclear,129,136,Cellular_component	"[{""token"": ""nuclear"", ""start_span"": 129, ""end_span"": 136, ""type"": ""Cellular_component""}]"	test
Chromatin immunoprecipitation assays show that E2F1 - E2F4 are bound in vivo to the ASK - 1 promoter in cycling cells, probably through a non - consensus E2F - binding site located 12 bp upstream of the transcription start site.	Chromatin,0,9,Cellular_component	"[{""token"": ""Chromatin"", ""start_span"": 0, ""end_span"": 9, ""type"": ""Cellular_component""}]"	test
Faithful chromosome segregation depends on the opposing activities of the budding yeast Glc7 / PP1 protein phosphatase and Ipl1 / Aurora protein kinase.	chromosome,9,19,Cellular_component	"[{""token"": ""chromosome"", ""start_span"": 9, ""end_span"": 19, ""type"": ""Cellular_component""}]"	test
These data strongly suggest that Glc7 ensures accurate chromosome segregation by dephosphorylating Ipl1 targets rather than regulating the Ipl1 kinase.	chromosome,55,65,Cellular_component	"[{""token"": ""chromosome"", ""start_span"": 55, ""end_span"": 65, ""type"": ""Cellular_component""}]"	test
In addition, the overexpression of Gip3 and Gip4 from the galactose promoter restored Dam1 phosphorylation in ipl1 - 321 mutant cells and caused wild - type cells to arrest in metaphase with unsegregated chromosomes, suggesting that Gip3 and Gip4 overexpression impairs Glc7 ' s mitotic functions.	chromosomes,204,215,Cellular_component	"[{""token"": ""chromosomes"", ""start_span"": 204, ""end_span"": 215, ""type"": ""Cellular_component""}]"	test
Detection of catalase in rat heart mitochondria.	mitochondria,35,47,Cellular_component	"[{""token"": ""mitochondria"", ""start_span"": 35, ""end_span"": 47, ""type"": ""Cellular_component""}]"	test
The presence of heme - containing catalase in rat heart mitochondria ( 20 + / - 5 units / mg) was demonstrated by biochemical and immunocytochemical analysis.	mitochondria,56,68,Cellular_component	"[{""token"": ""mitochondria"", ""start_span"": 56, ""end_span"": 68, ""type"": ""Cellular_component""}]"	test
Intact rat heart mitochondria efficiently consumed exogenously added H2O2.	mitochondria,17,29,Cellular_component	"[{""token"": ""mitochondria"", ""start_span"": 17, ""end_span"": 29, ""type"": ""Cellular_component""}]"	test
Hydrogen peroxide decomposition by mitochondria yielded molecular oxygen in a 2: 1 stoichiometry, consistent with a catalytic mechanism.	mitochondria,35,47,Cellular_component	"[{""token"": ""mitochondria"", ""start_span"": 35, ""end_span"": 47, ""type"": ""Cellular_component""}]"	test
Electrophoretic analysis and Western blotting of the mitochondrial matrix fraction indicated the presence of a protein with similar electrophoretic mobility to bovine and rat liver catalase and immunoreactive to anti - catalase antibody.	mitochondrial matrix,53,73,Cellular_component	"[{""token"": ""mitochondrial matrix"", ""start_span"": 53, ""end_span"": 73, ""type"": ""Cellular_component""}]"	test
Myocardial tissue has a lower catalase - specific activity and a greater mitochondrial H2O2 production / g of tissue than most organs.	mitochondrial,73,86,Cellular_component	"[{""token"": ""mitochondrial"", ""start_span"": 73, ""end_span"": 86, ""type"": ""Cellular_component""}]"	test
Nuclear export of S6K1 II is regulated by protein kinase CK2 phosphorylation at Ser - 17.	Nuclear,0,7,Cellular_component	"[{""token"": ""Nuclear"", ""start_span"": 0, ""end_span"": 7, ""type"": ""Cellular_component""}]"	test
Ribosomal S6 kinases ( S6Ks) are principal players in the regulation of cell growth and energy metabolism.	Ribosomal,0,9,Cellular_component	"[{""token"": ""Ribosomal"", ""start_span"": 0, ""end_span"": 9, ""type"": ""Cellular_component""}]"	test
Functional studies reveal that, in contrast to the wild type kinase, the phosphorylation - mimicking mutant of S6K1 II ( S17E) retains its cytoplasmic localization in serum - stimulated cells.	cytoplasmic,139,150,Cellular_component	"[{""token"": ""cytoplasmic"", ""start_span"": 139, ""end_span"": 150, ""type"": ""Cellular_component""}]"	test
These results indicate that nuclear import of the S17E mutant is not affected, although the export is significantly enhanced.	nuclear,28,35,Cellular_component	"[{""token"": ""nuclear"", ""start_span"": 28, ""end_span"": 35, ""type"": ""Cellular_component""}]"	test
We also provide evidence that nuclear export of S6K1 is mediated by a CRM1 - dependent mechanism.	nuclear,30,37,Cellular_component	"[{""token"": ""nuclear"", ""start_span"": 30, ""end_span"": 37, ""type"": ""Cellular_component""}]"	test
Taken together, this study establishes a functional link between S6K1 II and CK2 signaling, which involves the regulation of S6K1 II nuclear export by CK2 - mediated phosphorylation of Ser - 17.	nuclear,133,140,Cellular_component	"[{""token"": ""nuclear"", ""start_span"": 133, ""end_span"": 140, ""type"": ""Cellular_component""}]"	test
In acm1Delta strains, Cdh1 localization to the bud neck and association with two substrates, Clb2 and Hsl1, were strongly enhanced.	bud neck,47,55,Cellular_component	"[{""token"": ""bud neck"", ""start_span"": 47, ""end_span"": 55, ""type"": ""Cellular_component""}]"	test
Third, ACM1 deletion exacerbated a low - penetrance elongated - bud phenotype caused by modest overexpression of Cdh1.	bud,64,67,Cellular_component	"[{""token"": ""bud"", ""start_span"": 64, ""end_span"": 67, ""type"": ""Cellular_component""}]"	test
Effects on bud elongation were attenuated when Cdh1 was replaced with a mutant lacking the C - terminal IR dipeptide, suggesting that APC / C - dependent proteolysis is required for this phenotype.	bud,11,14,Cellular_component	"[{""token"": ""bud"", ""start_span"": 11, ""end_span"": 14, ""type"": ""Cellular_component""}]"	test
Hyperthermia ( HS) and 4 - hydroperoxycyclophosphamide ( 4CP) activate the mitochondrial apoptotic pathway in day 9 mouse embryos.	mitochondrial,75,88,Cellular_component	"[{""token"": ""mitochondrial"", ""start_span"": 75, ""end_span"": 88, ""type"": ""Cellular_component""}]"	test
HS and 4CP also induced an increase in Noxa and Puma mRNAs, transcripts of two known proapoptotic p53 target genes; however, these two teratogens did not induce significant increases in NOXA and PUMA proteins, suggesting that p53 does not activate the mitochondrial apoptotic pathway by transcriptionally upregulating the expression of NOXA and PUMA proteins.	mitochondrial,252,265,Cellular_component	"[{""token"": ""mitochondrial"", ""start_span"": 252, ""end_span"": 265, ""type"": ""Cellular_component""}]"	test
MSK1, and its related isoform MSK2, phosphorylate the transcription factors CREB ( cAMP - response - element - binding protein) and ATF1 ( activating transcription factor 1), and the chromatin proteins histone H3 and HMGN1 ( high - mobility - group nucleosomal - binding protein 1) in response to either mitogenic stimulation or cellular stress.	chromatin,183,192,Cellular_component	"[{""token"": ""chromatin"", ""start_span"": 183, ""end_span"": 192, ""type"": ""Cellular_component""}]"	test
The Aurora kinase Ipl1 maintains the centromeric localization of PP2A to protect cohesin during meiosis.	centromeric,37,48,Cellular_component	"[{""token"": ""centromeric"", ""start_span"": 37, ""end_span"": 48, ""type"": ""Cellular_component""}]"	test
This protection requires the conserved MEI - S332 / Sgo1 proteins that localize to centromeric regions and also recruit the PP2A phosphatase by binding its regulatory subunit, Rts1.	centromeric regions,83,102,Cellular_component	"[{""token"": ""centromeric regions"", ""start_span"": 83, ""end_span"": 102, ""type"": ""Cellular_component""}]"	test
Centromeric Rts1 / PP2A then locally prevents cohesion dissolution possibly by dephosphorylating the protein complex cohesin.	Centromeric,0,11,Cellular_component	"[{""token"": ""Centromeric"", ""start_span"": 0, ""end_span"": 11, ""type"": ""Cellular_component""}]"	test
We show that Aurora B kinase in Saccharomyces cerevisiae ( Ipl1) is also essential for the protection of meiotic centromeric cohesion.	centromeric,113,124,Cellular_component	"[{""token"": ""centromeric"", ""start_span"": 113, ""end_span"": 124, ""type"": ""Cellular_component""}]"	test
Furthermore, we show that Sgo1 recruits Ipl1 to centromeric regions.	centromeric regions,48,67,Cellular_component	"[{""token"": ""centromeric regions"", ""start_span"": 48, ""end_span"": 67, ""type"": ""Cellular_component""}]"	test
Immunoprecipitation of p65 and IkappaBalpha revealed that acute alcohol exposure for 1 h decreased NF - kappaB - IkappaBalpha complexes in the cytoplasm.	cytoplasm,143,152,Cellular_component	"[{""token"": ""cytoplasm"", ""start_span"": 143, ""end_span"": 152, ""type"": ""Cellular_component""}]"	test
Furthermore, nuclear expression of IKKalpha increased after alcohol treatment, which may contribute to inhibition of NF - kappaB.	nuclear,13,20,Cellular_component	"[{""token"": ""nuclear"", ""start_span"": 13, ""end_span"": 20, ""type"": ""Cellular_component""}]"	test
Decreased phosphorylation of nuclear p65 at Ser ( 276) was likely not due to alcohol - induced inhibition of protein kinase A and mitogen - and stress - activated protein kinase - 1 activity.	nuclear,29,36,Cellular_component	"[{""token"": ""nuclear"", ""start_span"": 29, ""end_span"": 36, ""type"": ""Cellular_component""}]"	test
S6K1 - mediated disassembly of mitochondrial URI / PP1gamma complexes activates a negative feedback program that counters S6K1 survival signaling.	mitochondrial,31,44,Cellular_component	"[{""token"": ""mitochondrial"", ""start_span"": 31, ""end_span"": 44, ""type"": ""Cellular_component""}]"	test
S6 kinase 1 ( S6K1) acts to integrate nutrient and growth factor signals to promote cell growth but also cell survival as a mitochondria - tethered protein kinase that phosphorylates and inactivates the proapoptotic molecule BAD.	mitochondria,124,136,Cellular_component	"[{""token"": ""mitochondria"", ""start_span"": 124, ""end_span"": 136, ""type"": ""Cellular_component""}]"	test
Here we report that the prefoldin chaperone URI represents a mitochondrial substrate of S6K1.	mitochondrial,61,74,Cellular_component	"[{""token"": ""mitochondrial"", ""start_span"": 61, ""end_span"": 74, ""type"": ""Cellular_component""}]"	test
In growth factor - deprived or rapamycin - treated cells, URI forms stable complexes with protein phosphatase ( PP) 1gamma at mitochondria, thereby inhibiting the activity of the bound enzyme.	mitochondria,126,138,Cellular_component	"[{""token"": ""mitochondria"", ""start_span"": 126, ""end_span"": 138, ""type"": ""Cellular_component""}]"	test
Bub1 kinase targets Sgo1 to ensure efficient chromosome biorientation in budding yeast mitosis.	chromosome,45,55,Cellular_component	"[{""token"": ""chromosome"", ""start_span"": 45, ""end_span"": 55, ""type"": ""Cellular_component""}]"	test
During cell division all chromosomes must be segregated accurately to each daughter cell.	chromosomes,25,36,Cellular_component	"[{""token"": ""chromosomes"", ""start_span"": 25, ""end_span"": 36, ""type"": ""Cellular_component""}]"	test
The mitotic role ( s) of Bub1 kinase activity remain elusive, and it is controversial whether this C - terminal domain of Bub1p is required for spindle checkpoint arrest.	spindle,144,151,Cellular_component	"[{""token"": ""spindle"", ""start_span"": 144, ""end_span"": 151, ""type"": ""Cellular_component""}]"	test
This is because bub1DeltaK cells display significant chromosome mis - segregation upon release from nocodazole arrest.	chromosome,53,63,Cellular_component	"[{""token"": ""chromosome"", ""start_span"": 53, ""end_span"": 63, ""type"": ""Cellular_component""}]"	test
bub1DeltaK cells mislocalise Sgo1p, and we demonstrate that both the Bub1 kinase domain and Sgo1p are required for accurate chromosome biorientation after nocodazole treatment.	chromosome,124,134,Cellular_component	"[{""token"": ""chromosome"", ""start_span"": 124, ""end_span"": 134, ""type"": ""Cellular_component""}]"	test
We propose that Bub1 kinase and Sgo1p act together to ensure efficient biorientation of sister chromatids during mitosis.	sister chromatids,88,105,Cellular_component	"[{""token"": ""sister chromatids"", ""start_span"": 88, ""end_span"": 105, ""type"": ""Cellular_component""}]"	test
Shugoshin promotes sister kinetochore biorientation in Saccharomyces cerevisiae.	kinetochore,26,37,Cellular_component	"[{""token"": ""kinetochore"", ""start_span"": 26, ""end_span"": 37, ""type"": ""Cellular_component""}]"	test
Chromosome segregation must be executed accurately during both mitotic and meiotic cell divisions.	Chromosome,0,10,Cellular_component	"[{""token"": ""Chromosome"", ""start_span"": 0, ""end_span"": 10, ""type"": ""Cellular_component""}]"	test
Sgo1 plays a key role in ensuring faithful chromosome segregation in at least two ways.	chromosome,43,53,Cellular_component	"[{""token"": ""chromosome"", ""start_span"": 43, ""end_span"": 53, ""type"": ""Cellular_component""}]"	test
Sgo1 plays only a minor role in segregating homologous chromosomes at meiosis I.	chromosomes,55,66,Cellular_component	"[{""token"": ""chromosomes"", ""start_span"": 55, ""end_span"": 66, ""type"": ""Cellular_component""}]"	test
In contrast, Sgo1 is important to bias sister kinetochores toward biorientation.	kinetochores,46,58,Cellular_component	"[{""token"": ""kinetochores"", ""start_span"": 46, ""end_span"": 58, ""type"": ""Cellular_component""}]"	test
We suggest that Sgo1 acts at sister kinetochores to promote their biorientation.	kinetochores,36,48,Cellular_component	"[{""token"": ""kinetochores"", ""start_span"": 36, ""end_span"": 48, ""type"": ""Cellular_component""}]"	test
Fisetin significantly suppressed I kappa B degradation, nuclear translocation of NF - kappa B, and phosphorylation of p38 mitogen - activated protein kinase ( MAPKs) in the LPS - stimulated BV - 2 microglia cells.	nuclear,56,63,Cellular_component	"[{""token"": ""nuclear"", ""start_span"": 56, ""end_span"": 63, ""type"": ""Cellular_component""}]"	test
It transfers the infection signal into the cell and promotes the translocation of nuclear factor kappa B ( NF - kappaB) to the nucleus and the subsequent transcriptional activation of genes encoding pro - and anti - inflammatory cytokines and chemokines.	nucleus,127,134,Cellular_component	"[{""token"": ""nucleus"", ""start_span"": 127, ""end_span"": 134, ""type"": ""Cellular_component""}]"	test
TLR - 4 and NF - kappaB were strongly expressed in the cytoplasm of hepatocytes in the AC group.	cytoplasm,55,64,Cellular_component	"[{""token"": ""cytoplasm"", ""start_span"": 55, ""end_span"": 64, ""type"": ""Cellular_component""}]"	test
Furthermore we find that overexpression of Bcl - x ( L), an inhibitor of cytoplasmic p53 after UV irradiation, prevents cell death.	cytoplasmic,73,84,Cellular_component	"[{""token"": ""cytoplasmic"", ""start_span"": 73, ""end_span"": 84, ""type"": ""Cellular_component""}]"	test
Analysis of nucleocytoplasmic shuttling of NF kappa B proteins in human leukocytes.	nucleocytoplasmic,12,29,Cellular_component	"[{""token"": ""nucleocytoplasmic"", ""start_span"": 12, ""end_span"": 29, ""type"": ""Cellular_component""}]"	test
Controlled nucleocytoplasmic localization regulates activity of NF kappa B as well as other transcription factors.	nucleocytoplasmic,11,28,Cellular_component	"[{""token"": ""nucleocytoplasmic"", ""start_span"": 11, ""end_span"": 28, ""type"": ""Cellular_component""}]"	test
The authors have previously shown that LMB inhibits NF kappa B activity in human neutrophils by increasing the nuclear accumulation of NF kappa B inhibitor, I kappa B alpha.	nuclear,111,118,Cellular_component	"[{""token"": ""nuclear"", ""start_span"": 111, ""end_span"": 118, ""type"": ""Cellular_component""}]"	test
In this chapter, the authors describe a protocol that uses LMB to study the nucleocytoplasmic shuttling of I kappa B alpha in human macrophage - like U937 cells, thus inhibiting NF kappa B activity.	nucleocytoplasmic,76,93,Cellular_component	"[{""token"": ""nucleocytoplasmic"", ""start_span"": 76, ""end_span"": 93, ""type"": ""Cellular_component""}]"	test
This protocol should be readily adaptable to analyze the nucleocytoplasmic shuttling of other proteins in human leukocytes.	nucleocytoplasmic,57,74,Cellular_component	"[{""token"": ""nucleocytoplasmic"", ""start_span"": 57, ""end_span"": 74, ""type"": ""Cellular_component""}]"	test
This suppression of NOS2 by DCS correlates with the attenuation of the NF - kappaB signaling pathway as measured by IL - 1beta - induced phosphorylation of the inhibitor of kappa B ( IkappaB) - alpha, degradation of IkappaB - alpha and IkappaB - beta, and subsequent nuclear translocation of NF - kappaB p65.	nuclear,267,274,Cellular_component	"[{""token"": ""nuclear"", ""start_span"": 267, ""end_span"": 274, ""type"": ""Cellular_component""}]"	test
Nuclear cross - talk was directly tested using the mammalian Gal4 / VP16 two - hybrid, and confirmed by co - immunoprecipitation / western blotting assays.	Nuclear,0,7,Cellular_component	"[{""token"": ""Nuclear"", ""start_span"": 0, ""end_span"": 7, ""type"": ""Cellular_component""}]"	test
Lipopolysaccharide ( LPS) is an outer - membrane glycolipid component of Gram - negative bacteria known for its fervent ability to activate monocytic cells and for its potent proinflammatory capabilities.	outer - membrane,32,48,Cellular_component	"[{""token"": ""outer - membrane"", ""start_span"": 32, ""end_span"": 48, ""type"": ""Cellular_component""}]"	test
In addition, we also found that induction of BAG3 was implicated in monocytic cell adhesion to extracellular matrix induced by LPS.	extracellular matrix,95,115,Cellular_component	"[{""token"": ""extracellular matrix"", ""start_span"": 95, ""end_span"": 115, ""type"": ""Cellular_component""}]"	test
Overall, the data support that BAG3 is induced by LPS via JNK and NF - kappaB - dependent signals, and involved in monocytic cell - extracellular matrix interaction, suggesting that BAG3 may have a role in the host response to LPS stimulation.	extracellular matrix,132,152,Cellular_component	"[{""token"": ""extracellular matrix"", ""start_span"": 132, ""end_span"": 152, ""type"": ""Cellular_component""}]"	test
In H1299 cells expressing mutant p53, chromatin immunoprecipitation ( ChIP) assays indicate that mutant p53 induces histone acetylation at specific sites on the regulatory regions of its target genes.	chromatin,38,47,Cellular_component	"[{""token"": ""chromatin"", ""start_span"": 38, ""end_span"": 47, ""type"": ""Cellular_component""}]"	test
In chromatin immunoprecipitation assay, TIP60 was primarily recruited to the IL - 6, IL - 8, C - IAP1, and XIAP promoters in TNF - alpha stimulation followed by acetylation of histones H3 and H4.	chromatin,3,12,Cellular_component	"[{""token"": ""chromatin"", ""start_span"": 3, ""end_span"": 12, ""type"": ""Cellular_component""}]"	test
Chromatin remodeling by TIP60 involved the sequential recruitment of acetyl - Lys - 310 RelA / p65 to its target gene promoters.	Chromatin,0,9,Cellular_component	"[{""token"": ""Chromatin"", ""start_span"": 0, ""end_span"": 9, ""type"": ""Cellular_component""}]"	test
Rp - cAMPS, a cAMP competitor, significantly corrected Nrf2 activity in CF cells, predominantly by increasing the nuclear accumulation of the transcription factor.	nuclear,114,121,Cellular_component	"[{""token"": ""nuclear"", ""start_span"": 114, ""end_span"": 121, ""type"": ""Cellular_component""}]"	test
Escape from the host immune system is essential for intracellular pathogens.	intracellular,52,65,Cellular_component	"[{""token"": ""intracellular"", ""start_span"": 52, ""end_span"": 65, ""type"": ""Cellular_component""}]"	test
Various functions have been implicated for optineurin such as regulation of receptor endocytosis, vesicle trafficking, regulation of the nuclear factor kappaB ( NF - kappaB) pathway and antiviral signaling.	vesicle,98,105,Cellular_component	"[{""token"": ""vesicle"", ""start_span"": 98, ""end_span"": 105, ""type"": ""Cellular_component""}]"	test
Taken together, we conclude that optineurin despite its substantial role in vesicular trafficking, endocytosis of cell surface receptors and recruitment to the TNFR1 complex is dispensable for the 14. 7K - mediated protection against TNF - induced apoptosis.	cell surface,114,126,Cellular_component	"[{""token"": ""cell surface"", ""start_span"": 114, ""end_span"": 126, ""type"": ""Cellular_component""}]"	test
Consistent with a critical role of IKKalpha in the transcriptional activity of NF - kappaB, IKKalpha deficiency drastically decreased NF - kappaB trans - activation by Tax, although it only modestly reduced Tax - mediated I - kappaBalpha degradation and NF - kappaB nuclear localization.	nuclear,266,273,Cellular_component	"[{""token"": ""nuclear"", ""start_span"": 266, ""end_span"": 273, ""type"": ""Cellular_component""}]"	test
The functional alteration was further analyzed by measuring the effects of phosphorylation on the ability of the factor to catalyse the ribosome - dependent hydrolysis of GTP.	ribosome,136,144,Cellular_component	"[{""token"": ""ribosome"", ""start_span"": 136, ""end_span"": 144, ""type"": ""Cellular_component""}]"	test
However, the phosphorylated factor showed a marked reduction in the second - order rate constant, suggesting that the phosphorylation interfered with ribosome. eEF - 2 complex formation by reducing the affinity of eEF - 2 for the ribosome.	ribosome,150,158,Cellular_component	"[{""token"": ""ribosome"", ""start_span"": 150, ""end_span"": 158, ""type"": ""Cellular_component""}]"	test
This assumption was confirmed by direct measurements of the dissociation constants for the ribosomal complexes containing unmodified and phosphorylated eEF - 2.	ribosomal,91,100,Cellular_component	"[{""token"": ""ribosomal"", ""start_span"": 91, ""end_span"": 100, ""type"": ""Cellular_component""}]"	test
NF - kappa B is a heterodimer of 50 - and 65 - kDa subunits sequestered in the cytoplasm complexed to inhibitory protein I kappa B.	cytoplasm,79,88,Cellular_component	"[{""token"": ""cytoplasm"", ""start_span"": 79, ""end_span"": 88, ""type"": ""Cellular_component""}]"	test
Following stimulation of cells, I kappa B dissociates from NF - kappa B, allowing its translocation to the nucleus, where it carries out the transactivation function.	nucleus,107,114,Cellular_component	"[{""token"": ""nucleus"", ""start_span"": 107, ""end_span"": 114, ""type"": ""Cellular_component""}]"	test
We demonstrate here that overexpression of zeta PKC is by itself sufficient to stimulate a permanent translocation of functionally active NF - kappa B into the nucleus of NIH 3T3 fibroblasts and that transfection of a kinase - defective dominant negative mutant of zeta PKC dramatically inhibits the kappa B - dependent transactivation of a chloramphenicol acetyltransferase reporter plasmid in NIH 3T3 fibroblasts.	nucleus,160,167,Cellular_component	"[{""token"": ""nucleus"", ""start_span"": 160, ""end_span"": 167, ""type"": ""Cellular_component""}]"	test
A specific interaction of active Rac with PI 3 - kinase might be important in regulation of the actin cytoskeleton.	cytoskeleton,102,114,Cellular_component	"[{""token"": ""cytoskeleton"", ""start_span"": 102, ""end_span"": 114, ""type"": ""Cellular_component""}]"	test
( R) - 3 - Hydroxybutyrate dehydrogenase ( BDH) is a lipid - requiring mitochondrial enzyme with a specific requirement of phosphatidylcholine ( PC) for function.	mitochondrial,71,84,Cellular_component	"[{""token"": ""mitochondrial"", ""start_span"": 71, ""end_span"": 84, ""type"": ""Cellular_component""}]"	test
The enzyme serves as a paradigm to study specific lipid - protein interactions in membranes.	membranes,82,91,Cellular_component	"[{""token"": ""membranes"", ""start_span"": 82, ""end_span"": 91, ""type"": ""Cellular_component""}]"	test
The K ( m) s for NAD + and ( R) - 3 - hydroxybutyrate ( R - HOB) of expressed BDH are similar to those for bovine heart or rat liver BDH in mitochondria.	mitochondria,140,152,Cellular_component	"[{""token"": ""mitochondria"", ""start_span"": 140, ""end_span"": 152, ""type"": ""Cellular_component""}]"	test
Here the intracellular distribution of E2F and DP proteins was investigated in transiently transfected Chinese hamster and human cells.	intracellular,9,22,Cellular_component	"[{""token"": ""intracellular"", ""start_span"": 9, ""end_span"": 22, ""type"": ""Cellular_component""}]"	test
In transfected cells, DP - 1 did not accumulate in the nucleus unless it was coexpressed with the heterodimeric partners E2F - 1, E2F - 2, or E2F - 3.	nucleus,55,62,Cellular_component	"[{""token"": ""nucleus"", ""start_span"": 55, ""end_span"": 62, ""type"": ""Cellular_component""}]"	test
Domain mapping experiments showed that regions of E2F - 1 and DP - 1 that are required for stable association of the two proteins were also required for nuclear localization of DP - 1.	nuclear,153,160,Cellular_component	"[{""token"": ""nuclear"", ""start_span"": 153, ""end_span"": 160, ""type"": ""Cellular_component""}]"	test
These results indicate that DP proteins preferentially associate with specific E2F partners, and suggest that the ability of specific E2F / DP heterodimers to localize in the nucleus contributes to the regulation of E2F activity.	nucleus,175,182,Cellular_component	"[{""token"": ""nucleus"", ""start_span"": 175, ""end_span"": 182, ""type"": ""Cellular_component""}]"	test
In human T lymphocytes, c - Rel is sequestered in the cytoplasmic compartment by constitutively phosphorylated inhibitors, including I ( kappa) B ( alpha) and I ( kappa) B ( beta).	cytoplasmic compartment,54,77,Cellular_component	"[{""token"": ""cytoplasmic compartment"", ""start_span"": 54, ""end_span"": 77, ""type"": ""Cellular_component""}]"	test
NIS charge movements are attributed to the conformational changes of the empty transporter within the membrane electric field.	membrane,102,110,Cellular_component	"[{""token"": ""membrane"", ""start_span"": 102, ""end_span"": 110, ""type"": ""Cellular_component""}]"	test
Transporter density in the plasma membrane was determined using freeze - fracture electron microscopy.	plasma membrane,27,42,Cellular_component	"[{""token"": ""plasma membrane"", ""start_span"": 27, ""end_span"": 42, ""type"": ""Cellular_component""}]"	test
IL - 1 is a proinflammatory cytokine that signals through a receptor complex of two different transmembrane chains to generate multiple cellular responses, including activation of the transcription factor NF - kappaB.	transmembrane,94,107,Cellular_component	"[{""token"": ""transmembrane"", ""start_span"": 94, ""end_span"": 107, ""type"": ""Cellular_component""}]"	test
The characterization of butyrate transport across pig and human colonic luminal membrane.	colonic luminal membrane,64,88,Cellular_component	"[{""token"": ""colonic luminal membrane"", ""start_span"": 64, ""end_span"": 88, ""type"": ""Cellular_component""}]"	test
The transport of butyrate into the luminal membrane vesicles was enhanced 5 - fold at pH 5. 5 compared with pH 8. 0.	luminal membrane vesicles,35,60,Cellular_component	"[{""token"": ""luminal membrane vesicles"", ""start_span"": 35, ""end_span"": 60, ""type"": ""Cellular_component""}]"	test
The described properties of butyrate transport across the luminal pole of the colon suggest the involvement of a carrier protein, in the form of a pH - activated anion exchange process.	luminal pole,58,70,Cellular_component	"[{""token"": ""luminal pole"", ""start_span"": 58, ""end_span"": 70, ""type"": ""Cellular_component""}]"	test
KILLER / DR5 gene encodes a DR containing cell surface protein that is highly homologous to DR4, another DR of the tumor necrosis factor ( TNF) receptor family.	cell surface,42,54,Cellular_component	"[{""token"": ""cell surface"", ""start_span"": 42, ""end_span"": 54, ""type"": ""Cellular_component""}]"	test
TRID ( also known as TRAIL - R3) is an antiapoptotic decoy receptor that lacks the cytoplasmic death domain and competes with KILLER / DR5 and DR4 for binding to TRAIL.	cytoplasmic,83,94,Cellular_component	"[{""token"": ""cytoplasmic"", ""start_span"": 83, ""end_span"": 94, ""type"": ""Cellular_component""}]"	test
Control of cyclin B1 localization through regulated binding of the nuclear export factor CRM1.	nuclear,67,74,Cellular_component	"[{""token"": ""nuclear"", ""start_span"": 67, ""end_span"": 74, ""type"": ""Cellular_component""}]"	test
In support of this hypothesis, we found that treatment of cells with leptomycin B, which disrupted Cyclin B1 - CRM1 interactions, led to a marked nuclear accumulation of Cyclin B1.	nuclear,146,153,Cellular_component	"[{""token"": ""nuclear"", ""start_span"": 146, ""end_span"": 153, ""type"": ""Cellular_component""}]"	test
In mitosis, Cyclin B1 undergoes phosphorylation at several sites, a subset of which have been proposed to play a role in Cyclin B1 accumulation in the nucleus.	nucleus,151,158,Cellular_component	"[{""token"": ""nucleus"", ""start_span"": 151, ""end_span"": 158, ""type"": ""Cellular_component""}]"	test
Cdc5p accumulates in the nuclei of G2 / M - phase cells, and its levels decline dramatically as cells progress through anaphase and begin telophase.	nuclei,25,31,Cellular_component	"[{""token"": ""nuclei"", ""start_span"": 25, ""end_span"": 31, ""type"": ""Cellular_component""}]"	test
Fucosylated complex glycoconjugates at the cell surface can then be recognized by specific counter - receptors in interacting cells, these mechanisms initiating important processes including inflammation and metastasis.	cell surface,43,55,Cellular_component	"[{""token"": ""cell surface"", ""start_span"": 43, ""end_span"": 55, ""type"": ""Cellular_component""}]"	test
