Sentence	entity_1	json	split
Depending on the substrate composition, average residence times over both reactors compartments vary between 110 and 125days.	reactors,74,82,engineered	"[{""token"": ""reactors"", ""start_span"": 74, ""end_span"": 82, ""type"": ""engineered""}]"	test
Determination of Alkylbenzene Utilization in hNRB Enrichments To the first set of microcosms a known volume of mesitylene ( 1, 3, 5 - trimethylbenzene) was added to the oil layer at the end of incubation period.	microcosms,82,92,engineered	"[{""token"": ""microcosms"", ""start_span"": 82, ""end_span"": 92, ""type"": ""engineered""}]"	test
Molecular Techniques DNA Extraction Environmental DNA was extracted from the basalt panel surfaces using a large - volume CTAB ( hexadecyltrimethylammonium bromide) extraction.	panel,84,89,engineered	"[{""token"": ""panel"", ""start_span"": 84, ""end_span"": 89, ""type"": ""engineered""}]"	test
DNA extraction, PCR, sequencing and data analysis Biomass for DNA extraction was collected three times per week, both from the withdrawn reactor samples ( granular phase) and from the effluent ( suspended phase), at the end of the aerated phase.	reactor,137,144,engineered	"[{""token"": ""reactor"", ""start_span"": 137, ""end_span"": 144, ""type"": ""engineered""}]"	test
Table1Total liquid volume, L2. 5pH8. 500. 05Salinity, Na + M1Temperature, C35. 00. 1H2S loading, mM S day - 158. 2ORP set - point, mV - 390 Biomass sources Biomass samples for inoculation were collected from four different full - scale systems for gas biodesulfurization, which have been in operation for more than ten years.	systems for gas biodesulfurization,236,270,engineered	"[{""token"": ""systems for gas biodesulfurization"", ""start_span"": 236, ""end_span"": 270, ""type"": ""engineered""}]"	test
DNA was extracted from the planktonic or solid phase of the wood chip reactors and from the drainage water ( inoculum).	reactors,70,78,engineered	"[{""token"": ""reactors"", ""start_span"": 70, ""end_span"": 78, ""type"": ""engineered""}]"	test
At each sampling event, a volume of fresh synthetic feed was also added to the batch reactors to replace the sampled volume and to maintain 0. 23kg COD / ( m3day) organic loading.	batch reactors,79,93,engineered	"[{""token"": ""batch reactors"", ""start_span"": 79, ""end_span"": 93, ""type"": ""engineered""}]"	test
Accumulibacter phosphatis, we performed a metagenomic assessment of the microbial community in the reactor.	reactor,99,106,engineered	"[{""token"": ""reactor"", ""start_span"": 99, ""end_span"": 106, ""type"": ""engineered""}]"	test
Accumulibacter phosphatis UW - LDO - ICs genes nirS, narG, norZ, and nosZ; the ccoN subunit of cbb3; and the ctaD subunit of aa3 cytochrome oxidases were designed to quantify expression of these genes in cDNA samples from the reactor.	reactor,226,233,engineered	"[{""token"": ""reactor"", ""start_span"": 226, ""end_span"": 233, ""type"": ""engineered""}]"	test
Material and Methods Sites description Research was conducted at Fujia forest farm, Changtu County, northwest of Liaoning province ( 12332E12355E4253N4321N).	forest farm,71,82,engineered	"[{""token"": ""forest farm"", ""start_span"": 71, ""end_span"": 82, ""type"": ""engineered""}]"	test
Temporal sedimentwater samples were recovered biweekly from each microcosm during a 28 day period in aliquots of 3 mL using a 3 mL syringe fitted with an 21G needle.	microcosm,65,74,engineered	"[{""token"": ""microcosm"", ""start_span"": 65, ""end_span"": 74, ""type"": ""engineered""}]"	test
To monitor reactor performance, mixed liquor and effluent samples were collected, filtered through a membrane filter ( Whatman, Maidstone, United Kingdom) ( 0. 45 - m pore size), and analyzed for acetate, PO43 - - P, NH3 plus NH4 + - N, NO3 - - N, and NO2 - - N.	reactor,11,18,engineered	"[{""token"": ""reactor"", ""start_span"": 11, ""end_span"": 18, ""type"": ""engineered""}]"	test
For 16S rRNA - based tag sequencing and metagenomic analyses, biomass samples from the reactors were collected weekly and stored at 80C until DNA extraction was performed.	reactors,87,95,engineered	"[{""token"": ""reactors"", ""start_span"": 87, ""end_span"": 95, ""type"": ""engineered""}]"	test
MATERIALS AND METHODS Bioelectrochemical cell.	Bioelectrochemical cell,22,45,engineered	"[{""token"": ""Bioelectrochemical cell"", ""start_span"": 22, ""end_span"": 45, ""type"": ""engineered""}]"	test
All mothers attending the clinics during the recruitment periods at each location were invited to participate in the study and written consent was obtained from all who agreed to participate.	clinics,26,33,engineered	"[{""token"": ""clinics"", ""start_span"": 26, ""end_span"": 33, ""type"": ""engineered""}]"	test
Methods Materials and methods Fecal samples were collected from dogs ( Cases) diagnosed with MUO at the veterinary hospitals of Iowa State University ( ISU) and Texas A & M University ( TAMU) and stored in a - 80C freezer for analysis at completion of case recruitment.	veterinary hospitals,104,124,engineered	"[{""token"": ""veterinary hospitals"", ""start_span"": 104, ""end_span"": 124, ""type"": ""engineered""}]"	test
The cohort included COPD patients with a FEV1 below 50% from the reference [ 16], who reported three or more exacerbations in the previous year and who had attended the Day Care Unit of Sabadell University Hospital since 2005.	Day Care Unit of Sabadell University Hospital,169,214,engineered	"[{""token"": ""Day Care Unit of Sabadell University Hospital"", ""start_span"": 169, ""end_span"": 214, ""type"": ""engineered""}]"	test
All batch reactors were then incubated at 37C to simulate the typical temperature in Saudi Arabia, and continuously mixed at 100rpm for sludge acclimation.	batch reactors,4,18,engineered	"[{""token"": ""batch reactors"", ""start_span"": 4, ""end_span"": 18, ""type"": ""engineered""}]"	test
Study on a Fermented Whole Wheat: Phenolic Content, Activity on PTP1B Enzyme and In Vitro Prebiotic Properties Fermented cereals, staple foods in Asia and Africa, are recently receiving a growing interest in Western countries.	foods,137,142,engineered	"[{""token"": ""foods"", ""start_span"": 137, ""end_span"": 142, ""type"": ""engineered""}]"	test
The remaining cohort of chicks from the sampled breeder flock was placed in the lower story of a two - story commercial broiler house ( hereafter called the monitored flock).	broiler house,120,133,engineered	"[{""token"": ""broiler house"", ""start_span"": 120, ""end_span"": 133, ""type"": ""engineered""}]"	test
The batch reactors were placed on a stir - bar hot plate ( VWR, # 97042 - 642) operated at 321C and 150rpm.	batch reactors,4,18,engineered	"[{""token"": ""batch reactors"", ""start_span"": 4, ""end_span"": 18, ""type"": ""engineered""}]"	test
pH and redox potential in the reactors were monitored with a Mettler Toledo pH probe ( HA405 - DPA - SC - S8 / 225) and a Mettler Toledo Redox probe ( Pt4805 - DPA - SC - S8 / 225) respectively ( Mettler Toledo GmbH, Germany).	reactors,30,38,engineered	"[{""token"": ""reactors"", ""start_span"": 30, ""end_span"": 38, ""type"": ""engineered""}]"	train
Initial partial pressure of CO in the headspace of the reactor was 0kPa.	reactor,55,62,engineered	"[{""token"": ""reactor"", ""start_span"": 55, ""end_span"": 62, ""type"": ""engineered""}]"	train
Introduction Sourdough positively influences the sensory, nutritional, textural, and shelf - life features of leavened baked goods ( De Vuyst et al., 2009; Gobbetti et al., 2014).	baked goods,119,130,engineered	"[{""token"": ""baked goods"", ""start_span"": 119, ""end_span"": 130, ""type"": ""engineered""}]"	train
DNA extraction and sequencing DNA was extracted from M - Core sediment and water samples using the MoBio PowerMax soil DNA isolation kit, according to manufacturer protocols ( ~ 5 g slurry / extraction).	M - Core,53,61,engineered	"[{""token"": ""M - Core"", ""start_span"": 53, ""end_span"": 61, ""type"": ""engineered""}]"	train
For scanning electron microscopic ( SEM) images, lignite particle and sponge samples were prefixed in 2. 5% ( w / v) glutaraldehyde in the anaerobic medium used for the DHS reactor cultivation without organic compounds.	reactor,173,180,engineered	"[{""token"": ""reactor"", ""start_span"": 173, ""end_span"": 180, ""type"": ""engineered""}]"	train
Sand for the mesocosm experiments was sampled from Orange beach and St. George in excess of 4 kg during a sampling trip in August 2011 and were stored on ice and then stored at 4C until use in the mesocosms.	mesocosm,13,21,engineered	"[{""token"": ""mesocosm"", ""start_span"": 13, ""end_span"": 21, ""type"": ""engineered""}]"	train
Inhibition effect of humic acid ( HA) on anaerobic digestion of cellulose and xylan and the mitigation potential of the inhibition were evaluated in controlled fed batch reactors at 30C and a hydraulic retention time ( HRT) of 20days.	reactors,170,178,engineered	"[{""token"": ""reactors"", ""start_span"": 170, ""end_span"": 178, ""type"": ""engineered""}]"	train
Samples were obtained from a commercial biogas reactor ( CD01, located in Sweden) that has endured high ammonia levels for extended periods and has been the focus of other research - and - development activities that have comprehensively described its operational history ( 5, 11, 12, 28).	biogas reactor,40,54,engineered	"[{""token"": ""biogas reactor"", ""start_span"": 40, ""end_span"": 54, ""type"": ""engineered""}]"	train
Both UASB reactors were filled with a methanogenic inoculum ( 1. 5L) and neutralized lactate - rich artificial medium ( 2L), and then incubated at room temperature ( 2025C).	reactors,10,18,engineered	"[{""token"": ""reactors"", ""start_span"": 10, ""end_span"": 18, ""type"": ""engineered""}]"	train
Growth with CO and different CO - rich gas mixtures by pure and mixed cultures 1mL of a CO - consuming culture ( mixed or pure isolate) in exponential growth was used to inoculate glass serum bottles ( 160mL) with 50mL reduced anaerobic medium and different substrates: CO, CO: CO2, CO: H2, CO: CO2: H2, or CO: yeast extract ( YE).	serum bottles,186,199,engineered	"[{""token"": ""serum bottles"", ""start_span"": 186, ""end_span"": 199, ""type"": ""engineered""}]"	train
Non - bioaugmented control bottles fed with steam - exploded birch ( pretreated + 0%) were prepared with the same amount of steam - exploded material and inoculum.	bottles,27,34,engineered	"[{""token"": ""bottles"", ""start_span"": 27, ""end_span"": 34, ""type"": ""engineered""}]"	train
16S rRNA gene amplicon sequences from the full - scale installations are deposited under EMBL - EBI project accession number PRJEB27163 and PRJEB32000.	full - scale installations,42,68,engineered	"[{""token"": ""full - scale installations"", ""start_span"": 42, ""end_span"": 68, ""type"": ""engineered""}]"	train
All reactors were operated at 30C in the dark without shaking.	reactors,4,12,engineered	"[{""token"": ""reactors"", ""start_span"": 4, ""end_span"": 12, ""type"": ""engineered""}]"	train
Computational fluid dynamics A fluid dynamic model of the MFC anode chamber was developed using the Ansys Fluent software ( ANSYS Academic Research, Release 12. 1).	MFC,58,61,engineered	"[{""token"": ""MFC"", ""start_span"": 58, ""end_span"": 61, ""type"": ""engineered""}]"	train
Microbial community analysis At the completion of the study, the samples collected from all batch bottles were analyzed for their microbial community composition.	batch bottles,92,105,engineered	"[{""token"": ""batch bottles"", ""start_span"": 92, ""end_span"": 105, ""type"": ""engineered""}]"	train
Pleasant Formation ( Utica - 3, Utica - 6, Utica - 7, and Utica - 8), and two natural - gas wells producing from the Marcellus Shale ( Marcellus - 4 and Marcellus - 5) ( Table 1).	natural - gas wells,78,97,engineered	"[{""token"": ""natural - gas wells"", ""start_span"": 78, ""end_span"": 97, ""type"": ""engineered""}]"	train
Six different electrodes, with 2 graphite foils ( catalog no. 43083, 1 mm thick; Alfa Aesar), 2 carbon felts ( catalog no. 43199, 3. 18 mm thick; Alfa Aesar), and 2 graphite rods ( catalog no. 14738, 6. 15 mm diameter; Alfa Aesar), with a projected area of approximately 11. 4 cm2 each, were installed in one working chamber of each MEC.	MEC,333,336,engineered	"[{""token"": ""MEC"", ""start_span"": 333, ""end_span"": 336, ""type"": ""engineered""}]"	train
Prior to afforestation, the vegetation type was Arachis hypogaea ( peanut) farmland, and the site information was shown in Table 1.	farmland,75,83,engineered	"[{""token"": ""farmland"", ""start_span"": 75, ""end_span"": 83, ""type"": ""engineered""}]"	train
Based on reports by NOAA ' s cleanup and assessment techniques, Orange beach was classified as heavily oiled following the DWH spill, while St. George had either trace or no oiling and was referred to as a control or un - impacted site in their assessment and in a previous study ( Newton et al., 2013).	DWH,123,126,engineered	"[{""token"": ""DWH"", ""start_span"": 123, ""end_span"": 126, ""type"": ""engineered""}]"	train
The previous DHS reactor columns were made of polyvinyl chloride19, 20; in this study, however, we used a glass column ( diameter 12cm; length 50cm) to maintain strict anaerobic conditions.	reactor,17,24,engineered	"[{""token"": ""reactor"", ""start_span"": 17, ""end_span"": 24, ""type"": ""engineered""}]"	train
( ii) MEC2 was operated by controlling the cathode potential at 0. 65 V versus SHE from the start of the experiment.	MEC2,6,10,engineered	"[{""token"": ""MEC2"", ""start_span"": 6, ""end_span"": 10, ""type"": ""engineered""}]"	train
K / BxN mice were generated by crossing KRN TCR transgenic mice on the B6 background with NOD mice and maintained at the University of Arizona.	University,121,131,engineered	"[{""token"": ""University"", ""start_span"": 121, ""end_span"": 131, ""type"": ""engineered""}]"	train
RNA was extracted from the same anaerobic reactor 2 days after the DNA extraction.	anaerobic reactor,32,49,engineered	"[{""token"": ""anaerobic reactor"", ""start_span"": 32, ""end_span"": 49, ""type"": ""engineered""}]"	train
Materials and Methods Study design Tissues were collected post mortem from poultry raised on commercial farms ( source: GNP company, St. Cloud, MN).	farms,104,109,engineered	"[{""token"": ""farms"", ""start_span"": 104, ""end_span"": 109, ""type"": ""engineered""}]"	train
Carbon Dioxide Analysis Produced gas samples were collected from the Marcellus - 4 natural - gas well over a period of 140 days.	natural - gas well,83,101,engineered	"[{""token"": ""natural - gas well"", ""start_span"": 83, ""end_span"": 101, ""type"": ""engineered""}]"	train
To set up comparative analyses, beach sand was collected from a beach in Orange Beach, AL that was severely impacted by oil contamination following the DWH spill and a beach on St. George Island, FL where negligible contamination was detected in the months following the blowout.	DWH,152,155,engineered	"[{""token"": ""DWH"", ""start_span"": 152, ""end_span"": 155, ""type"": ""engineered""}]"	train
The object of this work is the characterization of a fermented wheat used as a food ingredient and dietary supplement.	food,79,83,engineered	"[{""token"": ""food"", ""start_span"": 79, ""end_span"": 83, ""type"": ""engineered""}]"	train
Cultures were incubated at MHGC reservoir temperatures ( 30C) under dark and static conditions for 17 months.	MHGC reservoir,27,41,engineered	"[{""token"": ""MHGC reservoir"", ""start_span"": 27, ""end_span"": 41, ""type"": ""engineered""}]"	train
Table 2 summarizes the process performance data of the nitritation and anammox bioreactors during steady - state operation.	anammox bioreactors,71,90,engineered	"[{""token"": ""anammox bioreactors"", ""start_span"": 71, ""end_span"": 90, ""type"": ""engineered""}]"	train
The pH and the temperature of the reactors were not regulated, and varied in the range of 7. 09. 0 and 1921C, respectively.	reactors,34,42,engineered	"[{""token"": ""reactors"", ""start_span"": 34, ""end_span"": 42, ""type"": ""engineered""}]"	train
The reactor operated at 40C.	reactor,4,11,engineered	"[{""token"": ""reactor"", ""start_span"": 4, ""end_span"": 11, ""type"": ""engineered""}]"	train
Chemical analyses During the incubation period, microcosm headspaces were routinely monitored for methane production by gas chromatography ( GC; Fowler et al., 2012).	microcosm,48,57,engineered	"[{""token"": ""microcosm"", ""start_span"": 48, ""end_span"": 57, ""type"": ""engineered""}]"	train
This reactor sustained MCFA production for 252days ( 4).	reactor,5,12,engineered	"[{""token"": ""reactor"", ""start_span"": 5, ""end_span"": 12, ""type"": ""engineered""}]"	train
In addition to sequencing of 16S rRNA genes, an assay of the monooxygenase intergenic spacer region ( MISA) between two methane mono - oxygenase genes ( pmoC and pmoA) was performed following previously described protocols ( Tavormina et al., 2010; see Supplementary Text for modified primer sequences) on two samples: M - Core sediment and T45 sediment.	M - Core,319,327,engineered	"[{""token"": ""M - Core"", ""start_span"": 319, ""end_span"": 327, ""type"": ""engineered""}]"	train
Uninoculated tubes without nitrate were also prepared.	tubes,13,18,engineered	"[{""token"": ""tubes"", ""start_span"": 13, ""end_span"": 18, ""type"": ""engineered""}]"	train
Materials and Methods Sample Collection Basalt panels were deployed and recovered by DSV Alvin at Tica Vent on the EPR ( 950. 4 N, 10417. 5 W: 2513 - m depth; Figure 1) during R / V Atlantis research cruises AT11 - 04 ( 2003 / 12 / 01 2003 / 12 / 19), 11 - 07 ( 2004 / 02 / 03 2004 / 02 / 19), 11 - 10 ( 2004 / 04 / 07 2004 / 04 / 24), 11 - 20 ( 2004 / 11 / 11 2004 / 11 / 24).	panels,47,53,engineered	"[{""token"": ""panels"", ""start_span"": 47, ""end_span"": 53, ""type"": ""engineered""}]"	train
Fig 2 shows the anode chamber configuration scheme together with the fluid velocity and shear rate internal distributions under the MFCs operational conditions ( influent flow rates of 1. 5 Ld - 1 and recirculation flow rates of 170 Ld - 1).	MFCs,132,136,engineered	"[{""token"": ""MFCs"", ""start_span"": 132, ""end_span"": 136, ""type"": ""engineered""}]"	train
Prior to inoculation of serum bottles, the 16S rRNA gene of isolates SVCO - 15 and SVCO - 16 was directly amplified from genomic DNA for Sanger sequencing using the primer set 8F / 1525R, and the PCR conditions are described in [ 37].	serum bottles,24,37,engineered	"[{""token"": ""serum bottles"", ""start_span"": 24, ""end_span"": 37, ""type"": ""engineered""}]"	train
These panels are considered pre - eruption samples because they were collected 1928 months before the 2005 / 2006 EPR eruption ( Tolstoy et al., 2006; Cowen et al., 2007; Soule et al., 2007).	panels,6,12,engineered	"[{""token"": ""panels"", ""start_span"": 6, ""end_span"": 12, ""type"": ""engineered""}]"	train
Sodium lactate was added as electron donor at 20 mM. Selenite was added as Na2SeO3 at 5 mM. The reactor was flushed with N2 and then incubated for 21 days at 30C.	reactor,96,103,engineered	"[{""token"": ""reactor"", ""start_span"": 96, ""end_span"": 103, ""type"": ""engineered""}]"	train
Before inoculation, serum bottles were autoclaved for 1h at 121C.	serum bottles,20,33,engineered	"[{""token"": ""serum bottles"", ""start_span"": 20, ""end_span"": 33, ""type"": ""engineered""}]"	train
of Periodontology, University Hospital, Wuerzburg, Germany.	University Hospital,19,38,engineered	"[{""token"": ""University Hospital"", ""start_span"": 19, ""end_span"": 38, ""type"": ""engineered""}]"	train
of Periodontology and Restorative Dentistry, University Hospital, Muenster, Germany, and Dept.	University Hospital,45,64,engineered	"[{""token"": ""University Hospital"", ""start_span"": 45, ""end_span"": 64, ""type"": ""engineered""}]"	train
Three light oils, two light / heavy oils as well as heavy MHGC oil were used ( Table 1).	well,44,48,engineered	"[{""token"": ""well"", ""start_span"": 44, ""end_span"": 48, ""type"": ""engineered""}]"	train
The pH of the anammox bioreactor was maintained at between 6. 8 and 8. 0 and the reactor contents were completely mixed using a stir bar and gas sparging.	reactor,25,32,engineered	"[{""token"": ""reactor"", ""start_span"": 25, ""end_span"": 32, ""type"": ""engineered""}]"	train
Duplicate serum bottles for all oils and all nitrate concentrations were incubated upside down at 30C for 90 days, while shaking at 80 rpm.	serum bottles,10,23,engineered	"[{""token"": ""serum bottles"", ""start_span"": 10, ""end_span"": 23, ""type"": ""engineered""}]"	train
Wall Identifier Formation Sample days after fracturing Bacteria isolated Geochemical analyses performed Microbial analyses performed Figures present Utica - 3 Utica - Point Pleasant 38 - 460 Marinobacter sp. UTICA - S1B6 N - NH3, TN, S2, SO42 n / a Figure 2 Utica - 6 Utica - Point Pleasant 38 - 460 n / a N - NH3, TN, S2, SO42 n / a Figure 2 Utica - 7 Utica - Point Pleasant 38 - 460 n / a N - NH3, TN, S2, SO42 n / a Figure 2 Utica 8 Utica - Point Pleasant 38 - 460 Arcobacter sp. UTICA - S4D1 N - NH3, TN, S2, SO42 n / a Figure 2 Marcellus - 1 Marcellus 4 - 328 n / a n / a 16S EMIRGE Figure 3 Marcellus - 4 Marcellus 24 - 485 Arcobacter sp. MARC - MIP3H16 NH3, TN, S2, SO42, CI, NPOC, CO2 Metagenomics, 16S EMIRGE Figures 2, 3, 5 Marcellus - 5 Marcellus 35 496 n / a NH3, TN, S2, SO42 n / a Figure 2 Sample Collection Produced fluid samples were collected from six hydraulically fractured natural - gas wells in the northern Appalachian Basin: four from the Utica - Point Pleasant Formation ( Utica - 3, Utica - 6, Utica - 7, and Utica - 8) and two from the Marcellus Shale ( Marcellus - 4 and Marcellus - 5).	natural - gas wells,893,912,engineered	"[{""token"": ""natural - gas wells"", ""start_span"": 893, ""end_span"": 912, ""type"": ""engineered""}]"	train
Prior to inoculation with 2mL of the CO - enriched mixed culture derived from sludge, reactors were sparged with N2 ( UHP, Praxair) for 10min and sealed with butyl rubber and aluminum crimps.	reactors,86,94,engineered	"[{""token"": ""reactors"", ""start_span"": 86, ""end_span"": 94, ""type"": ""engineered""}]"	train
Enrichment of hNRB in Hungate Tubes hNRB were also cultivated in 20 ml Hungate tubes, containing 12. 5 ml of anoxic CSBK medium amended with 0, 10, 20, 40, or 80 mM nitrate.	Hungate tubes,71,84,engineered	"[{""token"": ""Hungate tubes"", ""start_span"": 71, ""end_span"": 84, ""type"": ""engineered""}]"	train
The final T45 time point consisted of sediment at the bottom of the HP - Core during the takedown of the experiment.	HP - Core,68,77,engineered	"[{""token"": ""HP - Core"", ""start_span"": 68, ""end_span"": 77, ""type"": ""engineered""}]"	train
Microbial community composition by 454 sequencing Samples from each reactor and from the manure were taken at the end of each experiment to determine microbial community composition ( nine samples) by 454 sequencing.	reactor,68,75,engineered	"[{""token"": ""reactor"", ""start_span"": 68, ""end_span"": 75, ""type"": ""engineered""}]"	train
DNA extraction and 16S rRNA gene amplicon sequencing Samples were collected from the MFC feed ( swine manure) and anode chambers once during steady - state operation ( day 43).	MFC,85,88,engineered	"[{""token"": ""MFC"", ""start_span"": 85, ""end_span"": 88, ""type"": ""engineered""}]"	train
This study focuses on metabolic transformation of lactate during the acetogenic and methanogenic steps of anaerobic digestion in methane - yielding bioreactors.	bioreactors,148,159,engineered	"[{""token"": ""bioreactors"", ""start_span"": 148, ""end_span"": 159, ""type"": ""engineered""}]"	train
To simulate projected reductions in precipitation ( De Castro et al., 2005), we used passive rainout shelters that intercept and exclude ~ 30% of the incoming rainfall from the plots.	rainout shelters,93,109,engineered	"[{""token"": ""rainout shelters"", ""start_span"": 93, ""end_span"": 109, ""type"": ""engineered""}]"	train
The starting concentration of nitrate ( 1. 18mmolL1) for the experiment corresponded to the highest nitrate concentration measured in December 2014 at one of the drainage sites.	drainage sites,162,176,engineered	"[{""token"": ""drainage sites"", ""start_span"": 162, ""end_span"": 176, ""type"": ""engineered""}]"	train
The total concentration of dissolved organic matter in the medium was 1. 13 mM - C. After 694 days of the reactor operation, we stopped adding organic regents ( i. e., acetate, propionate, butyrate, and yeast extract) to the medium.	reactor,106,113,engineered	"[{""token"": ""reactor"", ""start_span"": 106, ""end_span"": 113, ""type"": ""engineered""}]"	train
Methods Granular Sludge All granular sludges were collected from full - scale reactors in The Netherlands.	reactors,78,86,engineered	"[{""token"": ""reactors"", ""start_span"": 78, ""end_span"": 86, ""type"": ""engineered""}]"	train
Voltage was added to the circuit using a power supply ( model 1665; BK Precision, Yorba Linda, CA, USA), with reactors operated in fed - batch mode.	reactors,110,118,engineered	"[{""token"": ""reactors"", ""start_span"": 110, ""end_span"": 118, ""type"": ""engineered""}]"	train
External Resistances Applied to MFC Affect Core Microbiome and Swine Manure Treatment Efficiencies Microbial fuel cells ( MFCs) can be designed to combine water treatment with concomitant electricity production.	MFC,32,35,engineered	"[{""token"": ""MFC"", ""start_span"": 32, ""end_span"": 35, ""type"": ""engineered""}]"	train
On day 14, the fermenter was inoculated with slurry from existing biogas plants.	fermenter,15,24,engineered	"[{""token"": ""fermenter"", ""start_span"": 15, ""end_span"": 24, ""type"": ""engineered""}]"	train
Biomass and metagenomic DNA was isolated as previously described for the FW106 sample ( Hemme et al., 2010).	FW106,73,78,engineered	"[{""token"": ""FW106"", ""start_span"": 73, ""end_span"": 78, ""type"": ""engineered""}]"	train
Experimental procedures Source of inoculum and medium composition Granular sludge obtained from a 10L MOBB fed with syngas mixture ( 60% CO, 30% H2 and 10% CO2 ( v / v)) ( Pereira, 2014) was used as inoculum for batch incubations with CO.	MOBB,102,106,engineered	"[{""token"": ""MOBB"", ""start_span"": 102, ""end_span"": 106, ""type"": ""engineered""}]"	train
Changes in the microbiome structure are described according to the MFC fluid dynamics and the application of a maximum power point tracking system ( MPPT) compared to a fixed resistance system ( Ref - MFC).	MFC,67,70,engineered	"[{""token"": ""MFC"", ""start_span"": 67, ""end_span"": 70, ""type"": ""engineered""}]"	train
The initial total pressure of the serum bottles was 147kPa ( 1. 45atm).	serum bottles,34,47,engineered	"[{""token"": ""serum bottles"", ""start_span"": 34, ""end_span"": 47, ""type"": ""engineered""}]"	train
The abundance of sequence reads related to exopolysaccharides metabolism ( or synthesis / degradation) in the metagenomes of the anaerobic granules was compared to those found in the metagenomes of three full - scale activated sludge wastewater treatment systems available on MG - RAST ( Table S2).	wastewater treatment systems,234,262,engineered	"[{""token"": ""wastewater treatment systems"", ""start_span"": 234, ""end_span"": 262, ""type"": ""engineered""}]"	train
Materials and methods Microbial sludge sampling and sample preparation Biomass from a lab - scale, fed - batch biodesulfurization system, which was fed with H2S and methanethiol gas, was obtained after 76days of continuous operation.	biodesulfurization system,111,136,engineered	"[{""token"": ""biodesulfurization system"", ""start_span"": 111, ""end_span"": 136, ""type"": ""engineered""}]"	train
During this deployment, we discovered that the Teflon seal on the HP - Core was compromised, most likely by small sediment grains lodged against the Teflon core liner which resulted in a partial loss of pressure ( from 9. 9 Mpa down to ~ 2 MPa) during transit of the ROV Hyper - Dolphin from seafloor to the R / V Natsushima.	HP - Core,66,75,engineered	"[{""token"": ""HP - Core"", ""start_span"": 66, ""end_span"": 75, ""type"": ""engineered""}]"	train
The reactors were fed with a mixture of digestate and rain water and operated at nitrogen loading rates of 1. 0g TN / ( Lday) ( 103cycles) and 3. 4g TN / ( Lday) ( 41cycles).	reactors,4,12,engineered	"[{""token"": ""reactors"", ""start_span"": 4, ""end_span"": 12, ""type"": ""engineered""}]"	train
Microcosms were either provided with natural DOC ( final concentration of added DOC 0. 45 mg L1), which was enriched from river water, or acetate ( positive control, 820 mg L1).	Microcosms,0,10,engineered	"[{""token"": ""Microcosms"", ""start_span"": 0, ""end_span"": 10, ""type"": ""engineered""}]"	train
The final liquid volume was set to 193mL in all bottles by adding tap water.	bottles,48,55,engineered	"[{""token"": ""bottles"", ""start_span"": 48, ""end_span"": 55, ""type"": ""engineered""}]"	train
Incubations of Enriched Microbial Consortia at Different Manganese Oxide Activity Microcosms were prepared with the inoculum from the enriched birnessite - reducing culture ( transfer III).	Microcosms,82,92,engineered	"[{""token"": ""Microcosms"", ""start_span"": 82, ""end_span"": 92, ""type"": ""engineered""}]"	train
Sludge was obtained from the digester at two different time points 36 weeks apart ( March and December, 2011) enabling later differential coverage binning of genomes ( Albertsen et al., 2013).	digester,29,37,engineered	"[{""token"": ""digester"", ""start_span"": 29, ""end_span"": 37, ""type"": ""engineered""}]"	train
Total dissolved nitrogen ( TDN) was analyzed in samples from all wells by a Shimadzu TOC / TN analyzer ( see above), employing appropriate dilutions as needed for samples.	wells,65,70,engineered	"[{""token"": ""wells"", ""start_span"": 65, ""end_span"": 70, ""type"": ""engineered""}]"	train
Bacterial Isolation Marinobacter sp. UTICA - S1B6 was recovered from produced fluid collected from a Utica - Point Pleasant natural - gas well ( Utica - 3) on the first day of flowback using Difco Marine Broth 2216 ( DM2216) medium supplemented with 40 mM nitrate at 30C ( Figure 1, Tummings et al., 2018).	natural - gas well,124,142,engineered	"[{""token"": ""natural - gas well"", ""start_span"": 124, ""end_span"": 142, ""type"": ""engineered""}]"	train
Physicochemical Measurements The concentrations of total nitrogen, total phosphorus ( HACH tests), ammonium nitrogen, orthophosphates, and COD ( according to APHA 1992), as well as the pH and alkalinity ( TitroLine Easy), were measured in the reactor influent and effluent.	reactor,243,250,engineered	"[{""token"": ""reactor"", ""start_span"": 243, ""end_span"": 250, ""type"": ""engineered""}]"	train
During the operational period, the AnMBR was fed with synthetic wastewater with a chemical oxygen demand ( COD) concentration in the range of 450650 mg / L. The ammonium concentration in the influent was between 45 and 50 mg / L. Synthetic domestic wastewater was prepared using glucose and sodium acetate as the carbon sources and ammonium chloride as the ammonia source.	AnMBR,35,40,engineered	"[{""token"": ""AnMBR"", ""start_span"": 35, ""end_span"": 40, ""type"": ""engineered""}]"	train
For this purpose, two reactor sizes were used ( 10m3 and 16l), in which two temperature conditions ( 35C and 50C) were tested.	reactor,22,29,engineered	"[{""token"": ""reactor"", ""start_span"": 22, ""end_span"": 29, ""type"": ""engineered""}]"	train
Each test lead attached to the positive terminal had a 10 resistor connected in series for recording the voltage produced by each reactor using a multimeter ( model 34972A; Agilent Technologies, Santa Clara, CA, USA) in 20 min intervals.	reactor,130,137,engineered	"[{""token"": ""reactor"", ""start_span"": 130, ""end_span"": 137, ""type"": ""engineered""}]"	train
The sludge ( 13. 5 g / L wet sludge) was incubated in a 500 ml batch reactor with anaerobic mineral medium ( pH = 7. 3) containing the following components: 5. 6 mM NH4Cl, 0. 1 mM CaCl2. 2H2O, 1. 8 mM KH2PO4, 2. 0 mM Na2HPO4, and 3. 3.	batch reactor,63,76,engineered	"[{""token"": ""batch reactor"", ""start_span"": 63, ""end_span"": 76, ""type"": ""engineered""}]"	train
RNA Extraction and Sequencing RNA extraction from planktonic cells from the two MFCs was performed at the end of the experiment ( i. e., day 272) by sampling the anolyte, immediately mixing ( 1: 1 ratio) with RNA fix solution ( Feike et al., 2012), and cell capture on a 0. 22 m filter.	MFCs,80,84,engineered	"[{""token"": ""MFCs"", ""start_span"": 80, ""end_span"": 84, ""type"": ""engineered""}]"	train
The total volume of the batch reactors was 230mL, and the liquid was 50mL of reduced phosphate - buffered medium.	batch reactors,24,38,engineered	"[{""token"": ""batch reactors"", ""start_span"": 24, ""end_span"": 38, ""type"": ""engineered""}]"	train
Seawater from Red Sea was fed into each reactor at a continuous rate of 5 mL per minute.	reactor,40,47,engineered	"[{""token"": ""reactor"", ""start_span"": 40, ""end_span"": 47, ""type"": ""engineered""}]"	train
Physicochemical parameters of the biogas reactors Sample ID Day MSL ( tmonth1) DPM ( tmonth1) CM ( tmonth1) OLR ( kg oTSm3d1) CH4calc.	biogas reactors,34,49,engineered	"[{""token"": ""biogas reactors"", ""start_span"": 34, ""end_span"": 49, ""type"": ""engineered""}]"	train
Simulating riverbed burial and development of anoxic conditions, sediment microcosm experiments amended with Animas River dissolved organic carbon revealed the release of specific metal pools coupled to microbial Fe - and SO42 - reduction.	microcosm,74,83,engineered	"[{""token"": ""microcosm"", ""start_span"": 74, ""end_span"": 83, ""type"": ""engineered""}]"	train
The amount of added enzymes was expressed as milligrammes of protein per HA added to the reactors: 0. 6mg cellulase mgHAadded 1, 0. 075mg xylanase mgHAadded 1 and 0. 55mg endoglucanase mgHAadded 1 for P1 to P5, and the enzyme amount was reduced by half for P6.	reactors,89,97,engineered	"[{""token"": ""reactors"", ""start_span"": 89, ""end_span"": 97, ""type"": ""engineered""}]"	train
Cultures were amended with either a light oil ( API = 32) or MHGC heavy oil ( API = 16) in excess ( 20 mL) before sealing microcosms with butyl rubber stoppers and aluminum crimps.	microcosms,122,132,engineered	"[{""token"": ""microcosms"", ""start_span"": 122, ""end_span"": 132, ""type"": ""engineered""}]"	train
SCFAs are among the main products of cheese whey AD and, despite the low alkalinity typical of this waste, Fontana et al. have recently demonstrated the higher efficiency of a two - stage continuous stirred tank reactor ( CSTR) than a single - stage configuration for treating whey permeate and hard - cheese solid waste to produce biogas [ 10].	reactor,212,219,engineered	"[{""token"": ""reactor"", ""start_span"": 212, ""end_span"": 219, ""type"": ""engineered""}]"	train
Biomass samples, consisting of centrifuged and decanted 2 - ml aliquots, were collected at day 12, day 48, day 84, day 96, and day 120 of reactor operations from the day of initial startup.	reactor,138,145,engineered	"[{""token"": ""reactor"", ""start_span"": 138, ""end_span"": 145, ""type"": ""engineered""}]"	train
Two laboratory scale CSTRs were fed with synthetic media containing a mixture of volatile fatty acids ( VFA) as the sole carbon source, both started with an identical inoculum and operated in parallel but at different dilution rates ( 0. 18 and 0. 07 days - 1).	CSTRs,21,26,engineered	"[{""token"": ""CSTRs"", ""start_span"": 21, ""end_span"": 26, ""type"": ""engineered""}]"	train
Since 11th day of cultivationnon - neutralized medium supplied to the bioreactorSample collection for 16S rRNA profiling37th week of cultivation40th week of cultivationAnalyses performed on the samples collected from the UASB reactors shown in Table233rd40th week of cultivation35th40th week of cultivationSample collection for isotope analyses of fermentation gas44th50th week of cultivationaThe director of the Municipal Water and Sewage Enterprise in the capital city of Warsaw in Poland issued the permission to sample activated sludge and use it for scientific research Analytical methods The pH of the medium and the methanogenic effluents as well as the redox potential in the UASB reactor were measured using a standard pH meter ( ELMETRON model CP - 502) equipped with a combination ORP ( redox, mV) electrode - type ERPt - 13.	reactor,73,80,engineered	"[{""token"": ""reactor"", ""start_span"": 73, ""end_span"": 80, ""type"": ""engineered""}]"	train
At each time point of fermentation, three bottles were removed, the water kefirs were sieved, and the water kefir grains were washed with sterile saline ( 0. 85%, m / v, NaCl; Merck, Darmstadt, Germany) and stored at - 20C.	kefir,74,79,engineered	"[{""token"": ""kefir"", ""start_span"": 74, ""end_span"": 79, ""type"": ""engineered""}]"	train
Biomass samples of 100mL were withdrawn from the reactors three times per week.	reactors,49,57,engineered	"[{""token"": ""reactors"", ""start_span"": 49, ""end_span"": 57, ""type"": ""engineered""}]"	train
All microcosms contained 40 mM lactate and were inoculated with 7 ml of the birnessite - reducing culture.	microcosms,4,14,engineered	"[{""token"": ""microcosms"", ""start_span"": 4, ""end_span"": 14, ""type"": ""engineered""}]"	train
Biogas volume and methane percentage were monitored regularly during the acclimation phase for all batch reactors.	batch reactors,99,113,engineered	"[{""token"": ""batch reactors"", ""start_span"": 99, ""end_span"": 113, ""type"": ""engineered""}]"	train
Very high concentrations of pollutants in the digestate made it necessary to dilute the digestate prior to introduction to the biological reactor.	biological reactor,127,145,engineered	"[{""token"": ""biological reactor"", ""start_span"": 127, ""end_span"": 145, ""type"": ""engineered""}]"	train
mongolica, and Pinus tabuliformis were the main plantation forests in the Three North Shelterbelt ( Fig. 1).	plantation,48,58,engineered	"[{""token"": ""plantation"", ""start_span"": 48, ""end_span"": 58, ""type"": ""engineered""}]"	train
The composition of the medium for the DHS reactor was as follows ( l1): 5. 9mg sodium acetate, 7. 3mg sodium propionate, 8. 7mg sodium butyrate, 10mg yeast extract, 0. 53g NH4Cl, 0. 1g KH2PO4, 4g MgCl26H2O, 1g CaCl22H2O, 20g NaCl, 2g NaHCO3, 0. 1g Na2S9H2O, 2ml Ti ( III) - nitrilotriacetate, 1ml trace element solution75, 1ml vitamin solution76, and 1ml resazurin solution ( 1mgml1).	reactor,42,49,engineered	"[{""token"": ""reactor"", ""start_span"": 42, ""end_span"": 49, ""type"": ""engineered""}]"	train
In total, 78 samples were analyzed in this study, 26 from each reactor ( 13 from the granular phase and 13 from the effluent).	reactor,63,70,engineered	"[{""token"": ""reactor"", ""start_span"": 63, ""end_span"": 70, ""type"": ""engineered""}]"	train
Materials and Methods Laboratory - Scale CSTR Experiments Two laboratory - scale CSTRs with 6 L working volume were operated in parallel over 70 days at 37C but with different dilution rates ( 0. 18 and 0. 07 days - 1).	CSTR,41,45,engineered	"[{""token"": ""CSTR"", ""start_span"": 41, ""end_span"": 45, ""type"": ""engineered""}]"	train
The inocula came originally from the same municipal waste treatment plant.	municipal waste treatment plant,42,73,engineered	"[{""token"": ""municipal waste treatment plant"", ""start_span"": 42, ""end_span"": 73, ""type"": ""engineered""}]"	train
Briefly, the active members of MFC communities were identified through the phylogenetic placement of 16S rRNA reads, which were a subset from the total datasets extracted with SortMeRNA ( version 2. 1b), using default parameters ( Kopylova et al., 2012) and 16S rRNA reference databases provided by the authors on the tool repository1.	MFC,31,34,engineered	"[{""token"": ""MFC"", ""start_span"": 31, ""end_span"": 34, ""type"": ""engineered""}]"	train
The model was calibrated by measuring biological sulfide oxidation rates for different inocula obtained from four full - scale biodesulfurization installations fed with gases from various industries.	full - scale biodesulfurization installations,114,159,engineered	"[{""token"": ""full - scale biodesulfurization installations"", ""start_span"": 114, ""end_span"": 159, ""type"": ""engineered""}]"	train
After the first 30days ( P0) of the reactor operation, HA addition and inhibition mitigation experiments were started when the methane production stabilised.	reactor,36,43,engineered	"[{""token"": ""reactor"", ""start_span"": 36, ""end_span"": 43, ""type"": ""engineered""}]"	train
Samples and Reagents Four batches of Lisosan G ( LG1, LG2, LG3, LG4), a food supplement obtained from lysed fine bran and germ of organic wheat grains ( Triticum aestivum), were provided by Agrisan Srl Company, Larciano ( Pistoia, Italy).	food,72,76,engineered	"[{""token"": ""food"", ""start_span"": 72, ""end_span"": 76, ""type"": ""engineered""}]"	train
For warmed plants, all leaf gas exchange measurements were conducted under the prevailing microclimatic conditions within the OTCs ( i. e., elevated temperature and vapor pressure deficit relative to ambient).	OTCs,126,130,engineered	"[{""token"": ""OTCs"", ""start_span"": 126, ""end_span"": 130, ""type"": ""engineered""}]"	train
These chambers were made of transparent methacrylate, which transmits about 92% of visible light, has a reflection of incoming radiation of 4%, and passes on ca.	chambers,6,14,engineered	"[{""token"": ""chambers"", ""start_span"": 6, ""end_span"": 14, ""type"": ""engineered""}]"	train
Children ages 10 to 18years old with CF confirmed by genotype analysis were recruited from the CF program at Johns Hopkins University School of Medicine.	Johns Hopkins University School of Medicine,109,152,engineered	"[{""token"": ""Johns Hopkins University School of Medicine"", ""start_span"": 109, ""end_span"": 152, ""type"": ""engineered""}]"	train
The digestate from the sequential batch bottles was used as inoculum, which has a dry matter ( DM) content of 3. 8%, the volatile solid ( VS) content of 2. 1%, and the pH of 7. 8.	sequential batch bottles,23,47,engineered	"[{""token"": ""sequential batch bottles"", ""start_span"": 23, ""end_span"": 47, ""type"": ""engineered""}]"	train
The MECs were inoculated with 20 ml of a mixture of raw municipal wastewater and anaerobic digester sludge at a ratio of 9: 1 and then filled to 750 ml with a nutrient medium containing, per liter, 0. 1 g of KCl, 0. 6 g of KH2PO4, 0. 25 g of NH4Cl, 3 g of NaHCO3, 0. 1 g of MgCl, and 0. 03 g of CaCl.	MECs,4,8,engineered	"[{""token"": ""MECs"", ""start_span"": 4, ""end_span"": 8, ""type"": ""engineered""}]"	train
Materials and Methods Winter barley ( Hordeum vulgare L.) cultivar Kathleen was grown on an agricultural field in Braunschweig, Germany ( 521753N; 102646E) in 2013.	agricultural field,92,110,engineered	"[{""token"": ""agricultural field"", ""start_span"": 92, ""end_span"": 110, ""type"": ""engineered""}]"	train
A laboratory - scale SBR was used in this study.	SBR,21,24,engineered	"[{""token"": ""SBR"", ""start_span"": 21, ""end_span"": 24, ""type"": ""engineered""}]"	train
In addition, lower microbial diversity was found in the thermophilic reactors, especially for Bacteria, where a clear intensification towards Clostridia class members was evident.	reactors,69,77,engineered	"[{""token"": ""reactors"", ""start_span"": 69, ""end_span"": 77, ""type"": ""engineered""}]"	train
The reactors had a total working volume of 3L; they were continuously stirred at 150rpm using magnetic stirrers and equipped with thermal jackets to maintain the operating temperature at 551C.	reactors,4,12,engineered	"[{""token"": ""reactors"", ""start_span"": 4, ""end_span"": 12, ""type"": ""engineered""}]"	train
The bottles were flushed with nitrogen gas for a few minutes and sealed with septum and aluminum caps to maintain anaerobic conditions.	bottles,4,11,engineered	"[{""token"": ""bottles"", ""start_span"": 4, ""end_span"": 11, ""type"": ""engineered""}]"	train
The headspace in each bottle was flushed with nitrogen gas, and sealed to achieve anaerobic conditions.	bottle,22,28,engineered	"[{""token"": ""bottle"", ""start_span"": 22, ""end_span"": 28, ""type"": ""engineered""}]"	train
Analytical methods In addition to continuous measurements of pH and redox potential, alkalinity and total and volatile solids ( TS and VS) in the digesters were periodically analyzed.	digesters,146,155,engineered	"[{""token"": ""digesters"", ""start_span"": 146, ""end_span"": 155, ""type"": ""engineered""}]"	train
All bottles were incubated at 37C on a rotary shaker at 130rpm.	bottles,4,11,engineered	"[{""token"": ""bottles"", ""start_span"": 4, ""end_span"": 11, ""type"": ""engineered""}]"	train
Sludge samples, UASB1a - UASB5a, from the full - scale UASB reactor were taken from the sampling ports located at heights of 30cm, 100cm, 200cm, 300cm, and 400cm ( Table 1).	UASB reactor,55,67,engineered	"[{""token"": ""UASB reactor"", ""start_span"": 55, ""end_span"": 67, ""type"": ""engineered""}]"	train
After 20 days, exogenous SO42 ( 15 mM) was added to each microcosm to stimulate additional SO42 reduction.	microcosm,57,66,engineered	"[{""token"": ""microcosm"", ""start_span"": 57, ""end_span"": 66, ""type"": ""engineered""}]"	train
anaerogenes CP3 Aeromonas veronii CP10 Infection of biofilm with bacteriophages at various conditions To examine the effect of bacteriophages on the biofilm structure at various temperatures ( 25, 30, 37, and 45C) and pH values ( 5, 6, 7, 8), 28 drip flow reactors ( BioSurface Technologies Corp., Bozeman, MT) were assembled.	drip flow reactors,246,264,engineered	"[{""token"": ""drip flow reactors"", ""start_span"": 246, ""end_span"": 264, ""type"": ""engineered""}]"	train
This sampling depth was considered suitable because the fertile organic horizon is only 1 - 2 cm deep, and also because sampling deeper rhizosphere soil and roots would have been technically challenging and would have caused unacceptable disruption of the plant - soil system in this long - term field experiment.	field,296,301,engineered	"[{""token"": ""field"", ""start_span"": 296, ""end_span"": 301, ""type"": ""engineered""}]"	train
Sample locations are color - coded: alkaline spring systems within Murcilago and Potrero Grande watersheds are identified by green and yellow symbols, respectively; black triangles denote groundwater wells; pink square stands for a control surface water site.	groundwater wells,188,205,engineered	"[{""token"": ""groundwater wells"", ""start_span"": 188, ""end_span"": 205, ""type"": ""engineered""}]"	train
Sodium acetate ( 1. 62 g per liter) was added to MEC1 during the first 71 days to enrich bioanodes.	MEC1,49,53,engineered	"[{""token"": ""MEC1"", ""start_span"": 49, ""end_span"": 53, ""type"": ""engineered""}]"	train
The nitritation reactor had a working volume of 2l with a hydraulic retention time of 1 day50.	nitritation reactor,4,23,engineered	"[{""token"": ""nitritation reactor"", ""start_span"": 4, ""end_span"": 23, ""type"": ""engineered""}]"	train
Metatranscriptomic Analysis of the Active Community The original inoculum was obtained from an anaerobic SCN degrading stirred tank bio - reactor ( Broman et al., 2017).	stirred tank bio - reactor,119,145,engineered	"[{""token"": ""stirred tank bio - reactor"", ""start_span"": 119, ""end_span"": 145, ""type"": ""engineered""}]"	train
The home environment in which the dog lived was categorized as rural, semi - rural ( small town) or urban.	home environment,4,20,engineered	"[{""token"": ""home environment"", ""start_span"": 4, ""end_span"": 20, ""type"": ""engineered""}]"	train
Long - term injection of nitrate into the low - temperature ( 30C) Medicine Hat Glauconitic C ( MHGC) field gave nitrate breakthrough in some producing wells.	wells,152,157,engineered	"[{""token"": ""wells"", ""start_span"": 152, ""end_span"": 157, ""type"": ""engineered""}]"	train
After fabrication, deployment of the new HP - sampling device was tested on deep - sea sediments at the Joetsu Knoll, Japan, during the JAMSTEC research vessel ( R / V) Natsushima cruise NT1315 in July 2013 at a depth of 985 m ( i. e., 9. 9 MPa).	HP - sampling device,41,61,engineered	"[{""token"": ""HP - sampling device"", ""start_span"": 41, ""end_span"": 61, ""type"": ""engineered""}]"	train
Serum bottles were incubated at 30C and shaken horizontally at 125rpm to increase CO dissolution.	Serum bottles,0,13,engineered	"[{""token"": ""Serum bottles"", ""start_span"": 0, ""end_span"": 13, ""type"": ""engineered""}]"	train
Two full - scale systems, which treat sour gas from the anaerobic digestion of the wastewater from the paper pulp industry were sampled.	full - scale systems,4,24,engineered	"[{""token"": ""full - scale systems"", ""start_span"": 4, ""end_span"": 24, ""type"": ""engineered""}]"	train
The inoculum for Alk - Opt consisted of 1. 5 L of alkaline sludge obtained from a second alkaline reactor ( Alk - Sed - 2) which was inoculated with a second batch of fresh sediments obtained from the same soda lakes in 2012 and used within 6 months of the sampling date and had been operating for over 190 days with constant biogas production.	Alk - Opt,17,26,engineered	"[{""token"": ""Alk - Opt"", ""start_span"": 17, ""end_span"": 26, ""type"": ""engineered""}]"	train
We used high - throughput sequencing of the 16S rDNA gene to investigate the soil bacterial community diversity, structure, and functional characteristics in three plantation forests, including Populuscanadensis Moench ( PC), Pinus sylvestris var.	plantation forests,164,182,engineered	"[{""token"": ""plantation forests"", ""start_span"": 164, ""end_span"": 182, ""type"": ""engineered""}]"	train
Both CSTRs were fed continuously with a synthetic, liquid substrate containing a mixture of VFAs as the only carbon source ( 45% acetic, 45% butyric and 10% propionic acid based on chemical oxygen demand, COD) with a total concentration of 37. 2 gCOD L - 1 in a mineral medium containing all necessary trace elements, macronutrients and vitamins ( see Supplementary Table S1, Supplementary Material A).	CSTRs,5,10,engineered	"[{""token"": ""CSTRs"", ""start_span"": 5, ""end_span"": 10, ""type"": ""engineered""}]"	train
RNA RNA was extracted from ~ 500mg frozen reactor sample.	reactor,42,49,engineered	"[{""token"": ""reactor"", ""start_span"": 42, ""end_span"": 49, ""type"": ""engineered""}]"	train
Using the measured overpressure, headspace volume of the bottles and methane concentration as input, the ideal gas law was applied for calculating the volume of methane produced.	bottles,57,64,engineered	"[{""token"": ""bottles"", ""start_span"": 57, ""end_span"": 64, ""type"": ""engineered""}]"	train
Although the groundwater wells are located outside SEO, their recharge and flow paths originate within the ophiolite complex ( Snchez - Murillo et al., 2014).	groundwater wells,13,30,engineered	"[{""token"": ""groundwater wells"", ""start_span"": 13, ""end_span"": 30, ""type"": ""engineered""}]"	train
Here we characterized the chemical fingerprint of the polysaccharide fraction of EPS in anaerobic granules obtained from full - scale reactors treating different types of wastewater.	reactors,134,142,engineered	"[{""token"": ""reactors"", ""start_span"": 134, ""end_span"": 142, ""type"": ""engineered""}]"	train
Shortly, 20g of biogas reactor material was transferred into 120ml serum flasks under anaerobic conditions, sealed with a rubber stopper and purged with N2 / CO2 ( 50 / 50%, 1 atm) for 10min.	biogas reactor,16,30,engineered	"[{""token"": ""biogas reactor"", ""start_span"": 16, ""end_span"": 30, ""type"": ""engineered""}]"	train
Twenty eight cellulose acetate ultrafiltration membranes ( Sterilitech Corporation, Kent, WA), each with surface area of 11. 25 cm2, were secured on glass coupons and placed into the drip flow reactors to establish biofilm on the membranes.	drip flow reactors,183,201,engineered	"[{""token"": ""drip flow reactors"", ""start_span"": 183, ""end_span"": 201, ""type"": ""engineered""}]"	train
To a second set of microcosms, additional toluene ( 71. 2570 mM) was added to 1 ml of oil phase in bottles that showed less than 5 mM reduction of nitrate after 90 days of incubation.	microcosms,19,29,engineered	"[{""token"": ""microcosms"", ""start_span"": 19, ""end_span"": 29, ""type"": ""engineered""}]"	train
Samples collected during the time course experiment at T11 and T25 consisted of water from the effluent outflow at the top of the HP - Core.	HP - Core,130,139,engineered	"[{""token"": ""HP - Core"", ""start_span"": 130, ""end_span"": 139, ""type"": ""engineered""}]"	train
During the microaerobic stage, an on / off control system was used to limit the amount of oxygen pumped to the reactor ( 0. 02liters / min) and to maintain microaerobic conditions in the mixed liquor ( DO set point = 0. 2mg / liter).	reactor,111,118,engineered	"[{""token"": ""reactor"", ""start_span"": 111, ""end_span"": 118, ""type"": ""engineered""}]"	train
Each AS sample was sampled three times in the summer of 2015 at the same sample site ( different parts of the same tank), and then mixed together.	tank,115,119,engineered	"[{""token"": ""tank"", ""start_span"": 115, ""end_span"": 119, ""type"": ""engineered""}]"	train
Small subunit rRNA gene sequence analysis revealed that diverse microorganisms grew in the bioreactor ( e. g., phyla Proteobacteria, Firmicutes, Chloroflexi, Actinobacteria, Bacteroidetes, Spirochaetes, Tenericutes, Ignavibacteriae, and SBR1093).	bioreactor,91,101,engineered	"[{""token"": ""bioreactor"", ""start_span"": 91, ""end_span"": 101, ""type"": ""engineered""}]"	train
The average pollutant removal efficiency per month and influent characteristics for each of these WWTPs are summarized in Table1.	WWTPs,98,103,engineered	"[{""token"": ""WWTPs"", ""start_span"": 98, ""end_span"": 103, ""type"": ""engineered""}]"	train
13CH4 and 15N2 were injected at the start of the HP incubation experiment followed by periodic additions of 100% O2 on days 29, 30, 35, 37, 39, and 44 to stimulate aerobic methane - oxidation ( Figure 4).	HP,49,51,engineered	"[{""token"": ""HP"", ""start_span"": 49, ""end_span"": 51, ""type"": ""engineered""}]"	train
We note that Hmong refugee camps have long been closed ( Bureau of Population, Refugees and Migration, 2004), hence Hmong in Khun Chang Khian are not refugees but serve as acceptable pre - immigration representatives available for US - based Hmong.	camps,27,32,engineered	"[{""token"": ""camps"", ""start_span"": 27, ""end_span"": 32, ""type"": ""engineered""}]"	train
Reactor CD01 characteristics and metagenome and metaproteome features Characteristic or feature Link _ ADIa metagenomea Link _ ADIb metaproteome Sample features Collection yr 2013 2015 Substrate Slaughterhouse and municipal waste Municipal waste Temp ( C) 38 42 pH 7. 8 7. 7 N - NH4 + concn ( g / liter) 4. 6 2. 7 NH3 concn ( g / liter) 0. 36 0. 22 VFA concn ( g / liter) 1. 3 0. 45 HRT ( days) 45 33 OLR ( gVSb / liter / day) 3. 0 4. 2 Data set features and genome binsc Total DNA ( assembled) length ( Mb) Syntrophomonas sp. 1. 11 Tepidanaerobacter sp. 1. 32 Thermacetogenium sp. 0. 07 Methanosarcina sp. 0. 78 Methanoculleus sp. 2. 59 unFirm _ 1 2. 65d Total no. of proteins Syntrophomonas sp. 10 Tepidanaerobacter sp. 16 Thermacetogenium sp. 0 Methanosarcina sp. 8 Methanoculleus sp. 30e unFirm _ 1 176 Link _ ADIa corresponds to the sampling time used for metagenomic characterization of CD01.	Reactor,0,7,engineered	"[{""token"": ""Reactor"", ""start_span"": 0, ""end_span"": 7, ""type"": ""engineered""}]"	train
In short, produced fluid samples collected at 7 time points ( drilling mud sample prior to fracturing, days after fracturing 25, 34, 35, 79, 93, 142) from Marcellus Shale natural - gas well Marcellus - 4 ( 3001000 ml) were concentrated on a 0. 22 - m PES filter ( Nalgene; Fisher Scientific).	natural - gas well,171,189,engineered	"[{""token"": ""natural - gas well"", ""start_span"": 171, ""end_span"": 189, ""type"": ""engineered""}]"	train
First an aliquot was withdrawn from the microcosms and centrifuged ( 14, 000 rpm, 5 min).	microcosms,40,50,engineered	"[{""token"": ""microcosms"", ""start_span"": 40, ""end_span"": 50, ""type"": ""engineered""}]"	train
NP samples from infants and mothers were collected by pediatricians in the clinics using Copan Eswabs following manufacturer ' s instructions.	clinics,75,82,engineered	"[{""token"": ""clinics"", ""start_span"": 75, ""end_span"": 82, ""type"": ""engineered""}]"	train
For the two - stage CSTR system, the output gas and the liquid effluent from the acidogenic reactor ( R2) was transferred pneumatically to the methanogenic reactor ( R3) via a connecting tube ( Fig. 1).	CSTR system,20,31,engineered	"[{""token"": ""CSTR system"", ""start_span"": 20, ""end_span"": 31, ""type"": ""engineered""}]"	train
Dissolved oxygen in the reactor was maintained at 0. 50. 5mgl1 and bicarbonate present in the influent filtrate kept the pH buffered between 6. 5 and 8. 5.	reactor,24,31,engineered	"[{""token"": ""reactor"", ""start_span"": 24, ""end_span"": 31, ""type"": ""engineered""}]"	train
One reactor was operated under thermophilic conditions ( 50C) and one under mesophilic conditions ( 35C).	reactor,4,11,engineered	"[{""token"": ""reactor"", ""start_span"": 4, ""end_span"": 11, ""type"": ""engineered""}]"	train
454 - pyrosequencing and 16S rRNA gene sequence analysis The bacterial communities in inoculum from the 10 industrial biogas plants were investigated by amplification of genomic DNA using polymerase chain reaction ( PCR) primers targeting the bacterial 16S rRNA gene and integrated with 454 Life Sciences adaptors 8F ( 5 - CCT ATC CCC TGT GTG CCT TGG CAG TCT CAG CAA CAG CTA GAG TTT GAT CCT GG - 3) and 515R ( 5 - CCA TCT CAT CCC TGC GTG TCT CCG ACT CAG NNN NNN NNT TAC CGC GGC TGC T - 3 [ 107].	biogas plants,118,131,engineered	"[{""token"": ""biogas plants"", ""start_span"": 118, ""end_span"": 131, ""type"": ""engineered""}]"	train
For each inoculum, triplicate bottles were set up for straw and for cellulose.	bottles,30,37,engineered	"[{""token"": ""bottles"", ""start_span"": 30, ""end_span"": 37, ""type"": ""engineered""}]"	train
Patient Population and Sample Collection Patient data and rectal samples were obtained from The Study of Pathogen and Antimicrobial Use in Dementia ( SPREAD), a prospective cohort of 362 residents with advanced dementia in 35 nursing homes from the Boston, Massachusetts area, which quantified antimicrobial prescribing patterns for suspected infections and the acquisition of MDRO ( Mitchell et al., 2014).	nursing homes,226,239,engineered	"[{""token"": ""nursing homes"", ""start_span"": 226, ""end_span"": 239, ""type"": ""engineered""}]"	train
The reactor was operated under conditions of alternating anaerobic and low - oxygen 8 - h cycles.	reactor,4,11,engineered	"[{""token"": ""reactor"", ""start_span"": 4, ""end_span"": 11, ""type"": ""engineered""}]"	train
Modeling of the experimental setup Software simulations of the single and two - stage reactors were carried out using the complex anaerobic digestion simulation suite ( BioModel) developed by Angelidaki and co - workers [ 33, 34], which was later extended to account for biogas upgrading experiments with hydrogen injection [ 35].	reactors,86,94,engineered	"[{""token"": ""reactors"", ""start_span"": 86, ""end_span"": 94, ""type"": ""engineered""}]"	train
Constant temperature was assured for each individual reactor at 300. 5C, and operational pH was kept between 6. 8 and 7. 2 by adding 5M NaOH when necessary.	reactor,53,60,engineered	"[{""token"": ""reactor"", ""start_span"": 53, ""end_span"": 60, ""type"": ""engineered""}]"	train
MATERIALS AND METHODS Operation of laboratory - scale sequencing batch reactor.	sequencing batch reactor,54,78,engineered	"[{""token"": ""sequencing batch reactor"", ""start_span"": 54, ""end_span"": 78, ""type"": ""engineered""}]"	train
Metagenome and metatranscriptome analysis DNA and RNA extraction 15. 0 mL of sludge obtained from reactor Alk - Sed - 2 were used for DNA extraction.	reactor Alk - Sed - 2,98,119,engineered	"[{""token"": ""reactor Alk - Sed - 2"", ""start_span"": 98, ""end_span"": 119, ""type"": ""engineered""}]"	train
500mg of biomass was collected from the reactor, centrifuged at 4500, r. p. m.	reactor,40,47,engineered	"[{""token"": ""reactor"", ""start_span"": 40, ""end_span"": 47, ""type"": ""engineered""}]"	train
The medium was supplied to the UASB reactors using a peristaltic pump ( ZALIMP, Poland).	reactors,36,44,engineered	"[{""token"": ""reactors"", ""start_span"": 36, ""end_span"": 44, ""type"": ""engineered""}]"	train
Glass columns ( Chemglass; 7. 62 cm inner diameter by 30. 5 cm effective length), fitted with fritted glass supports, were filled with sand from Orange beach and St. George beach spiked with a mixture of three low molecular weight PAHs, naphthalene, fluorene, and benzo [] pyrene.	Glass columns,0,13,engineered	"[{""token"": ""Glass columns"", ""start_span"": 0, ""end_span"": 13, ""type"": ""engineered""}]"	train
Operation at optimal HRT and OLR conditions Alk - Opt reactor was operated at the optimal HRT, 15 days, and optimal OLR, 0. 25 g Spirulina L1 day1 ( dry weight).	Alk - Opt reactor,44,61,engineered	"[{""token"": ""Alk - Opt reactor"", ""start_span"": 44, ""end_span"": 61, ""type"": ""engineered""}]"	train
One graphite foil, one carbon felt, and one graphite rod electrode were installed at the top half of each MEC, and another set of electrodes was installed at the bottom half.	MEC,106,109,engineered	"[{""token"": ""MEC"", ""start_span"": 106, ""end_span"": 109, ""type"": ""engineered""}]"	train
Methane production of the biogas reactor samples was measured as previously described ( Refai etal., 2014).	biogas reactor,26,40,engineered	"[{""token"": ""biogas reactor"", ""start_span"": 26, ""end_span"": 40, ""type"": ""engineered""}]"	train
The gas absorber and the bioreactor temperature were regulated at 35 C by a thermostat bath ( DC10, Thermo Haake, Germany).	bioreactor,25,35,engineered	"[{""token"": ""bioreactor"", ""start_span"": 25, ""end_span"": 35, ""type"": ""engineered""}]"	train
Three graphite rod electrodes were used as counterelectrodes in the other chamber of each MEC.	MEC,90,93,engineered	"[{""token"": ""MEC"", ""start_span"": 90, ""end_span"": 93, ""type"": ""engineered""}]"	train
The material collected into the M - Core contained a mixture of sediment and bottom water, which by the time of recovery onboard ship had separated by density.	M - Core,32,40,engineered	"[{""token"": ""M - Core"", ""start_span"": 32, ""end_span"": 40, ""type"": ""engineered""}]"	train
Upon sampling, the UASB reactor achieved a TOC removal efficiency of 8590% with slightly high pH ( ~ 7. 5) in the effluent and high methane content ( > 90%) in the biogas stream.	UASB reactor,19,31,engineered	"[{""token"": ""UASB reactor"", ""start_span"": 19, ""end_span"": 31, ""type"": ""engineered""}]"	train
The plant converts ca.	plant,4,9,engineered	"[{""token"": ""plant"", ""start_span"": 4, ""end_span"": 9, ""type"": ""engineered""}]"	train
The anammox bioreactor was operated at room temperature with a hydraulic retention time of 2 days and no biomass wasting, which encouraged the formation of dense granules.	bioreactor,12,22,engineered	"[{""token"": ""bioreactor"", ""start_span"": 12, ""end_span"": 22, ""type"": ""engineered""}]"	train
Samples for total dissolved nitrogen, ammonia, and sulfate were filtered using 0. 45 m PES filters ( EMD Millipore, Burlington, MA, United States), with the exception of the Marcellus - 4 and Marcellus - 5 wells in which 0. 22 m PES filters were used, within 48 h of sampling and stored at 4C until analysis.	wells,206,211,engineered	"[{""token"": ""wells"", ""start_span"": 206, ""end_span"": 211, ""type"": ""engineered""}]"	train
The reactors were fed with a 5050% mixture of synthetic and real wastewater ( 6 - times diluted reject water from the dewatering of digested sludge).	reactors,4,12,engineered	"[{""token"": ""reactors"", ""start_span"": 4, ""end_span"": 12, ""type"": ""engineered""}]"	train
To these 1 ml of the oils ( 2% of total volume of 50 ml), listed in Table 1, was added as electron donor and 5 ml of produced water from 18PW was used to inoculate the bottles.	18PW,137,141,engineered	"[{""token"": ""18PW"", ""start_span"": 137, ""end_span"": 141, ""type"": ""engineered""}]"	train
Neutralization of the medium with calcium hydroxide ( 7g / L) was performed in a separate tank.	tank,90,94,engineered	"[{""token"": ""tank"", ""start_span"": 90, ""end_span"": 94, ""type"": ""engineered""}]"	train
Sludge inoculum of 100mL each was added to four 1. 2L dark glass bottles.	glass bottles,59,72,engineered	"[{""token"": ""glass bottles"", ""start_span"": 59, ""end_span"": 72, ""type"": ""engineered""}]"	train
The batch anaerobic digestion was performed in 309mL serum bottles, to which substrate was added corresponding to 3g volatile solids ( VS) per liter, and the inoculum: substrate ratio was between 2: 1 and 4: 1.	serum bottles,53,66,engineered	"[{""token"": ""serum bottles"", ""start_span"": 53, ""end_span"": 66, ""type"": ""engineered""}]"	train
Here we show that the microbiome of a commercial, ammonia - tolerant biogas reactor harbors a deeply branched, uncultured phylotype ( unFirm _ 1) accounting for approximately 5% of the 16S rRNA gene inventory and sharing 88% 16S rRNA gene identity with its closest characterized relative.	biogas reactor,69,83,engineered	"[{""token"": ""biogas reactor"", ""start_span"": 69, ""end_span"": 83, ""type"": ""engineered""}]"	train
The pH in the reactors varied between 9. 0 and 9. 5.	reactors,14,22,engineered	"[{""token"": ""reactors"", ""start_span"": 14, ""end_span"": 22, ""type"": ""engineered""}]"	train
MATERIALS AND METHODS Samples and biogas reactor operational data.	reactor,41,48,engineered	"[{""token"": ""reactor"", ""start_span"": 41, ""end_span"": 48, ""type"": ""engineered""}]"	train
The carbon source was added to the reactors to a bed width of 4cm and compacted using autoclaved stones.	reactors,35,43,engineered	"[{""token"": ""reactors"", ""start_span"": 35, ""end_span"": 43, ""type"": ""engineered""}]"	train
We also collected fecal samples from matched control dogs ( Controls) that were presented for diagnosis and treatment through the same veterinary school hospitals for other conditions.	veterinary school hospitals,135,162,engineered	"[{""token"": ""veterinary school hospitals"", ""start_span"": 135, ""end_span"": 162, ""type"": ""engineered""}]"	train
The initial volumetric organic loading rate ( OLR) was set at 0. 25 kg COD / m3 / day ( OLR), which corresponded to a hydraulic retention time ( HRT) of 37. 5 h. For microbial community analysis, samples of 40 mL of sludge from the AnMBR were taken from the recirculation loop to obtain representative samples, which were stored at 80 C for further analysis.	AnMBR,232,237,engineered	"[{""token"": ""AnMBR"", ""start_span"": 232, ""end_span"": 237, ""type"": ""engineered""}]"	train
ATP analysis One milliliter of fresh sludge from each anaerobic reactor was sampled and centrifuged at 3600g for 20min ( Centrifuge 5424R, Eppendorf, Germany).	reactor,64,71,engineered	"[{""token"": ""reactor"", ""start_span"": 64, ""end_span"": 71, ""type"": ""engineered""}]"	train
Twelve samples were collected from the start - up, steady - state, overloading and recovery periods of the AnMBR process.	AnMBR,107,112,engineered	"[{""token"": ""AnMBR"", ""start_span"": 107, ""end_span"": 112, ""type"": ""engineered""}]"	train
Materials and methods Participant recruitment and sputum collection From July to October of 2012, 6 knowledgeable and compliant cystic fibrosis ( CF) patients were recruited for this study from the Southern Alberta Adult Cystic Fibrosis Clinic.	Clinic,237,243,engineered	"[{""token"": ""Clinic"", ""start_span"": 237, ""end_span"": 243, ""type"": ""engineered""}]"	train
The elderly population residing in nursing homes are a major reservoir of MDRO.	nursing homes,35,48,engineered	"[{""token"": ""nursing homes"", ""start_span"": 35, ""end_span"": 48, ""type"": ""engineered""}]"	train
A negative control microcosm for each sediment sample did not receive additional DOC.	microcosm,19,28,engineered	"[{""token"": ""microcosm"", ""start_span"": 19, ""end_span"": 28, ""type"": ""engineered""}]"	train
Sampling and analytical analysis Samples from the laboratory bioreactors ( 57ml) were collected two to three times per week over a period of 200 days.	bioreactors,61,72,engineered	"[{""token"": ""bioreactors"", ""start_span"": 61, ""end_span"": 72, ""type"": ""engineered""}]"	train
A mixture of the crushed lignite and sandstone samples was used for the reactor cultivation.	reactor,72,79,engineered	"[{""token"": ""reactor"", ""start_span"": 72, ""end_span"": 79, ""type"": ""engineered""}]"	train
Profiling of microbial mat geochemical and light gradients were taken from mat samples placed in an 2 - L open channel reactor and Hot Lake water was pumped from the lake continuously during measurements ( Babauta etal. 2014).	reactor,119,126,engineered	"[{""token"": ""reactor"", ""start_span"": 119, ""end_span"": 126, ""type"": ""engineered""}]"	train
Microbial Community Analysis of hNRB Enrichments hNRB enrichments from microcosms with oils and the oils with added toluene were centrifuged at 12, 000 rpm for 30 min to collect cell pellets at the end of incubation period of 171180 days.	microcosms,71,81,engineered	"[{""token"": ""microcosms"", ""start_span"": 71, ""end_span"": 81, ""type"": ""engineered""}]"	train
DNA extraction and amplification Five millilitres of wellhomogenized MOBB sludge, CO ( x) and COP ( x) cultures was stored at 20C.	MOBB,69,73,engineered	"[{""token"": ""MOBB"", ""start_span"": 69, ""end_span"": 73, ""type"": ""engineered""}]"	train
Nitrogen and sulfur analyses were performed on all six wells while metagenomic analyses, near - full - length reconstruction of the 16S rRNA gene, NPOC, and CO2 analyses were performed on one well ( Marcellus - 4).	well,55,59,engineered	"[{""token"": ""well"", ""start_span"": 55, ""end_span"": 59, ""type"": ""engineered""}]"	train
Continuous cultivation Continuous incubations of the sampled microbial communities lasted 100 and 250 days, for two independent sets of experiments, and were conducted in custom culture vessels ( Hanke et al., 2014).	custom culture vessels,171,193,engineered	"[{""token"": ""custom culture vessels"", ""start_span"": 171, ""end_span"": 193, ""type"": ""engineered""}]"	train
Three private and municipal wells located nearby the SEO were also sampled ( 3070 m depth): Pozo Murcilago ( P. Murcilago), Pozo Nuevo ( P. Nuevo), and Pozo Aguas Calientes ( P. Aguas Calientes), as well as one control location at Ro Calera ( R. Calera) ( Figure 1).	wells,28,33,engineered	"[{""token"": ""wells"", ""start_span"": 28, ""end_span"": 33, ""type"": ""engineered""}]"	train
Inoculum was collected from the different biogas plants and incubated at 37C for 46days prior to the BMP test to decrease gas production from endogenous material.	biogas plants,42,55,engineered	"[{""token"": ""biogas plants"", ""start_span"": 42, ""end_span"": 55, ""type"": ""engineered""}]"	train
Serum bottles were immediately sealed with sterile black butyl stoppers and the headspace exchanged with N2: CO2.	Serum bottles,0,13,engineered	"[{""token"": ""Serum bottles"", ""start_span"": 0, ""end_span"": 13, ""type"": ""engineered""}]"	train
Metals associated with river sediments collected downstream of the Gold King Mine in August 2015 exhibited distinct presence and abundance patterns linked to location and mineralogy.	Gold King Mine,67,81,engineered	"[{""token"": ""Gold King Mine"", ""start_span"": 67, ""end_span"": 81, ""type"": ""engineered""}]"	train
The mean air and soil temperature increases achieved within the OTCs range from 1 - 2 C ( winter) to 4 - 7 C ( summer), which is in good agreement with climate change projections for the second half of the XXIst century in the study area ( Collins et al., 2013).	OTCs,64,68,engineered	"[{""token"": ""OTCs"", ""start_span"": 64, ""end_span"": 68, ""type"": ""engineered""}]"	train
The external resistance was initially kept at 1000 and switched to 560 from day 150 to 180 on for MFC A and B, respectively.	MFC,98,101,engineered	"[{""token"": ""MFC"", ""start_span"": 98, ""end_span"": 101, ""type"": ""engineered""}]"	train
The permanent ( non - moveable) rain exclusion shelters are made of transparent methacrylate troughs covering ~ 30% of the area of the experimental plots.	rain exclusion shelters,32,55,engineered	"[{""token"": ""rain exclusion shelters"", ""start_span"": 32, ""end_span"": 55, ""type"": ""engineered""}]"	train
The M1A bioreactor run lasted for 40weeks.	M1A bioreactor,4,18,engineered	"[{""token"": ""M1A bioreactor"", ""start_span"": 4, ""end_span"": 18, ""type"": ""engineered""}]"	train
The headspace of the microcosms was vacuumed and purged with N2 five times to ensure anaerobic conditions.	microcosms,21,31,engineered	"[{""token"": ""microcosms"", ""start_span"": 21, ""end_span"": 31, ""type"": ""engineered""}]"	train
pH was maintained at 7. 2 with 1N of NaOH and 3N of HCl in all reactors.	reactors,63,71,engineered	"[{""token"": ""reactors"", ""start_span"": 63, ""end_span"": 71, ""type"": ""engineered""}]"	train
Characterization and Dynamic Shift of Microbial Communities during Start - Up, Overloading and Steady - State in an Anaerobic Membrane Bioreactor A lab - scale anaerobic membrane bioreactor ( AnMBR) with a side stream tubular membrane was developed to treat synthetic domestic sewage to evaluate its performance and the dynamic shift of bacterial and archaeal communities during the start - up, steady - state, overloading and recovery periods of operation at mesophilic temperatures.	Bioreactor,135,145,engineered	"[{""token"": ""Bioreactor"", ""start_span"": 135, ""end_span"": 145, ""type"": ""engineered""}]"	train
The two MFCs operated under the same hydraulic conditions and differed only in the electrical load application ( Fig 1).	MFCs,8,12,engineered	"[{""token"": ""MFCs"", ""start_span"": 8, ""end_span"": 12, ""type"": ""engineered""}]"	train
The anammox bioreactor was originally inoculated with anammox biomass from the City College of New York ( Civil Engineering Department) that was enriched from activated sludge.	anammox bioreactor,4,22,engineered	"[{""token"": ""anammox bioreactor"", ""start_span"": 4, ""end_span"": 22, ""type"": ""engineered""}]"	train
Comparison of the bacterial community composition in the granular and the suspended phase of sequencing batch reactors Granulation of activated sludge is an increasingly important area within the field of wastewater treatment.	reactors,110,118,engineered	"[{""token"": ""reactors"", ""start_span"": 110, ""end_span"": 118, ""type"": ""engineered""}]"	train
Materials and methods Experimental setup and design The laboratory setup consisted of a falling film gas absorber integrated with a gas - lift reactor ( Fig. 1) ( Roman etal., 2016a).	gas - lift reactor,132,150,engineered	"[{""token"": ""gas - lift reactor"", ""start_span"": 132, ""end_span"": 150, ""type"": ""engineered""}]"	train
Additional research focusing on the microbial community compositions of these full - scale installations was based on 16S rRNA gene amplicon sequencing ( Kiragosyan et al. 2019).	full - scale installations,78,104,engineered	"[{""token"": ""full - scale installations"", ""start_span"": 78, ""end_span"": 104, ""type"": ""engineered""}]"	train
Validation of the developed qPCR assay To validate the developed qPCR methods, we used biomass from different five full - scale gas biodesulfurization installations ( Table1).	gas biodesulfurization installations,128,164,engineered	"[{""token"": ""gas biodesulfurization installations"", ""start_span"": 128, ""end_span"": 164, ""type"": ""engineered""}]"	train
Basalt panels were deployed either at a diffuse - flow vent site ( Experiment site 1: 15C) or a nearby, non - vent site ( Control site: 1. 8C).	panels,7,13,engineered	"[{""token"": ""panels"", ""start_span"": 7, ""end_span"": 13, ""type"": ""engineered""}]"	train
Materials and Methods Animals and Diet We used C57BL / 6 male mice ( 1214 weeks of age) obtained from the National Institutes of Health.	National Institutes of Health,106,135,engineered	"[{""token"": ""National Institutes of Health"", ""start_span"": 106, ""end_span"": 135, ""type"": ""engineered""}]"	train
Chemical Measurements For additional habitat characterization, we attached a time - series temperature sensor ( VEMCO) directly to one of the basalt panels at both the experimental ( attached to Day 293E) and control sites ( attached to Day 13C; Supplementary Figure S2) and deployed an in situ chemical sensor at Experiment site 1, to monitor dissolved H2S, Eh ( oxidation - reduction potential), and temperature ( Supplementary Figures S3AC).	panels,149,155,engineered	"[{""token"": ""panels"", ""start_span"": 149, ""end_span"": 155, ""type"": ""engineered""}]"	train
It is a sulfonate that appears in the composition of some cosmetics and detergents and that can therefore end up in wastewater treatment plants.	wastewater treatment plants,116,143,engineered	"[{""token"": ""wastewater treatment plants"", ""start_span"": 116, ""end_span"": 143, ""type"": ""engineered""}]"	train
Six biomass samples from within a reactor cycle on operational day 522 ( Fig. 1) were collected and immediately processed to determine transcript abundance.	reactor,34,41,engineered	"[{""token"": ""reactor"", ""start_span"": 34, ""end_span"": 41, ""type"": ""engineered""}]"	train
The first reactor served as control with no TC - HCl added.	reactor,10,17,engineered	"[{""token"": ""reactor"", ""start_span"": 10, ""end_span"": 17, ""type"": ""engineered""}]"	train
Five days later, the first substrate ( corn silage) was fed into the fermenter, this is day 1 in the subsequent analysis.	fermenter,69,78,engineered	"[{""token"": ""fermenter"", ""start_span"": 69, ""end_span"": 78, ""type"": ""engineered""}]"	train
Anaerobic conditions in the anammox bioreactor were maintained by continuously purging a mixture of 95% nitrogen gas and 5% carbon dioxide50.	anammox bioreactor,28,46,engineered	"[{""token"": ""anammox bioreactor"", ""start_span"": 28, ""end_span"": 46, ""type"": ""engineered""}]"	train
Briefly, the SBR had a 2 - liter working volume and was fed with synthetic wastewater containing acetate ( 500 mg chemical oxygen demand [ COD] / liter) as the sole carbon source ( C / P molar ratio of 20).	SBR,13,16,engineered	"[{""token"": ""SBR"", ""start_span"": 13, ""end_span"": 16, ""type"": ""engineered""}]"	train
PCR Amplification, Clone Library Construction, and Phylogenetic Analysis of Archaeal 16S rRNA Genes The archaeal communities obtained from various heights ( UASB1a - UASB5a) in a methanogenic bioreactor were investigated by denaturing gradient gel electrophoresis - ( DGGE -) cloning approaches through amplification of the 16S rRNA by using the primers Arc344f - mod and Arch958r - mod [ 16].	bioreactor,192,202,engineered	"[{""token"": ""bioreactor"", ""start_span"": 192, ""end_span"": 202, ""type"": ""engineered""}]"	train
The bottles running with steam - exploded birch with applied bioaugmentation ( pretreated + 215% v / v) received the same amount of steam - exploded material and inoculum, and different volumes of C. bescii culture, corresponding to 2, 5, 10, and 15% v / v of the volume of the inoculum.	bottles,4,11,engineered	"[{""token"": ""bottles"", ""start_span"": 4, ""end_span"": 11, ""type"": ""engineered""}]"	train
Presence of VFA was also measured for each of the reactors.	reactors,50,58,engineered	"[{""token"": ""reactors"", ""start_span"": 50, ""end_span"": 58, ""type"": ""engineered""}]"	train
Materials and Methods Experimental set - up and inoculation Two replicate, dual - chamber MFCs were constructed and operated to remove organic matter from swine manure with bioelectricity production.	MFCs,90,94,engineered	"[{""token"": ""MFCs"", ""start_span"": 90, ""end_span"": 94, ""type"": ""engineered""}]"	train
In line with recommendations for case - control studies [ 30], we specifically sought Control animals from those presented to our veterinary university clinics because they were derived from the same population as the Cases.	veterinary university clinics,130,159,engineered	"[{""token"": ""veterinary university clinics"", ""start_span"": 130, ""end_span"": 159, ""type"": ""engineered""}]"	train
Part of the experimental field showing 9 out of the 12 opentop chambers To test the growth response of this cultivar to elevated [ CO2], we measured shoot dry weight at anthesis and shoot dry weight, the length and dry weight of ears, weight of grains, and number of grains at maturity.	opentop chambers,55,71,engineered	"[{""token"": ""opentop chambers"", ""start_span"": 55, ""end_span"": 71, ""type"": ""engineered""}]"	train
DNA extraction and purification DNA was isolated from anaerobic digester samples using a modified bead beating protocol.	digester,64,72,engineered	"[{""token"": ""digester"", ""start_span"": 64, ""end_span"": 72, ""type"": ""engineered""}]"	train
Methods Inocula, feed composition, and experimental set - up for processing of lactate - rich media to methane An experimental set - up for collection of data enabling the description of metabolic transformation of lactate during the acetogenic and methanogenic steps of anaerobic digestion in methane - yielding bioreactors was presented in this study in two repeats.	bioreactors,313,324,engineered	"[{""token"": ""bioreactors"", ""start_span"": 313, ""end_span"": 324, ""type"": ""engineered""}]"	train
Basalt panels ( 10. 2 cm 10. 2 cm 2. 5 cm) were constructed of basalt collected in the area of 9N on the EPR ( Supplementary Figure S1D).	panels,7,13,engineered	"[{""token"": ""panels"", ""start_span"": 7, ""end_span"": 13, ""type"": ""engineered""}]"	train
DNA and RNA sequencing Two independent biomass samples were collected from the anammox bioreactor at different time points during periods of high total nitrogen removal efficiency ( > 80%).	anammox bioreactor,79,97,engineered	"[{""token"": ""anammox bioreactor"", ""start_span"": 79, ""end_span"": 97, ""type"": ""engineered""}]"	train
Continuous stirring of the reactors was obtained by anchor - type propellers at 100rpm.	reactors,27,35,engineered	"[{""token"": ""reactors"", ""start_span"": 27, ""end_span"": 35, ""type"": ""engineered""}]"	train
Ten plants were collected for these measurements from each OTC.	OTC,59,62,engineered	"[{""token"": ""OTC"", ""start_span"": 59, ""end_span"": 62, ""type"": ""engineered""}]"	train
One panel was lost ( 76 - days, control), leaving a total of nine panels for analysis, in addition to the native Basalt and Trap samples.	panel,4,9,engineered	"[{""token"": ""panel"", ""start_span"": 4, ""end_span"": 9, ""type"": ""engineered""}]"	train
The dilution rate is a crucial process parameter for continuous stirred tank reactors ( CSTR), which is one of the most prevalent reactor configurations for AD around the world, and particularly in Germany ( Weiland, 2010).	reactor,77,84,engineered	"[{""token"": ""reactor"", ""start_span"": 77, ""end_span"": 84, ""type"": ""engineered""}]"	train
Due to the limited volumes of PW fluids collected during the sampling trip, only one live replicate was prepared per oil type so as to ensure that adequate sterile ( autoclaved) replicates ( one for each oil type) and an oil - free control ( incubated for 21 months) could also be established.	PW,30,32,engineered	"[{""token"": ""PW"", ""start_span"": 30, ""end_span"": 32, ""type"": ""engineered""}]"	train
In each OTC, three plants were uprooted and their root systems combined.	OTC,8,11,engineered	"[{""token"": ""OTC"", ""start_span"": 8, ""end_span"": 11, ""type"": ""engineered""}]"	train
Samples were obtained from the wood chip reactors and treated with RNA Protect Solution ( Qiagen) prior to storage at 80C.	reactors,41,49,engineered	"[{""token"": ""reactors"", ""start_span"": 41, ""end_span"": 49, ""type"": ""engineered""}]"	train
Five reactors were fed every day for another 220days with synthetic medium, using cellulose ( avicel; PH - 101, Fluka, Darmstadt) and beech wood xylan ( Roth, Karlsruhe, Germany) at a ratio of 75: 25 ( w / w).	reactors,5,13,engineered	"[{""token"": ""reactors"", ""start_span"": 5, ""end_span"": 13, ""type"": ""engineered""}]"	train
For the first 100days, the plant was fed exclusively with corn silage at ca.	plant,27,32,engineered	"[{""token"": ""plant"", ""start_span"": 27, ""end_span"": 32, ""type"": ""engineered""}]"	train
Therefore, we determined that the overall risk of nitrate / nitrite inhibition of methanogenesis was low and that PW samples could be used to study methanogenic crude oil biodegradation.	PW,114,116,engineered	"[{""token"": ""PW"", ""start_span"": 114, ""end_span"": 116, ""type"": ""engineered""}]"	train
PAH degradation potential of the sand microbial community The potential for degradation of PAHs was tested in eight constructed mesocosms, three replicates with native sand communities collected August 2011 for each beach, Orange and St. George, and two abiotic controls.	mesocosms,128,137,engineered	"[{""token"": ""mesocosms"", ""start_span"": 128, ""end_span"": 137, ""type"": ""engineered""}]"	train
Potential for microbial H2 and metal transformations associated with novel bacteria and archaea in deep terrestrial subsurface sediments Geological sequestration in deep underground repositories is the prevailing proposed route for radioactive waste disposal.	deep underground repositories,165,194,engineered	"[{""token"": ""deep underground repositories"", ""start_span"": 165, ""end_span"": 194, ""type"": ""engineered""}]"	train
PCR amplification of 18S rRNA gene PCR amplification of 18S rRNA gene for bioreactor enrichment samples is also described in Supplementary Text2.	bioreactor,74,84,engineered	"[{""token"": ""bioreactor"", ""start_span"": 74, ""end_span"": 84, ""type"": ""engineered""}]"	train
The full - scale UASB reactor in Tainan, Taiwan had a working volume of approximately 1000m3 and has been operated for treating QMA - rich wastewater with HRT of 1. 32 days without temperature control ( 18 ~ 26C) for more than three years [ 4].	UASB reactor,17,29,engineered	"[{""token"": ""UASB reactor"", ""start_span"": 17, ""end_span"": 29, ""type"": ""engineered""}]"	train
To determine the microbial diversity of the two inocula and the reactor electrodes, as well as in the solutions, 16S rRNA genes were sequenced using 454 pyrosequencing with the primers 341F ( 5 - CCTAYGGGGYGCASCAG - 3) and 1000R ( 5 - GAGARGWRGTGCATGGCC - 3) for Archaea ( Gantner et al., 2011) as well as 27F ( 5 - AGAGTTTGATCCTGGCTCAG - 3; Lane, 1991) and 519R ( 5 - GTNTTACNGCGGCKGCTG - 3; Ishak et al., 2011) for Bacteria.	reactor,64,71,engineered	"[{""token"": ""reactor"", ""start_span"": 64, ""end_span"": 71, ""type"": ""engineered""}]"	train
Composition of the Bacterial Communities Bacterial community compositions of both CSTRs at the beginning and at the end of the experiment were analyzed by amplicon sequencing of 16S rRNA genes.	CSTRs,82,87,engineered	"[{""token"": ""CSTRs"", ""start_span"": 82, ""end_span"": 87, ""type"": ""engineered""}]"	train
This inoculum was used to run sequential batch bottles fed with untreated and steam - exploded birch.	sequential batch bottles,30,54,engineered	"[{""token"": ""sequential batch bottles"", ""start_span"": 30, ""end_span"": 54, ""type"": ""engineered""}]"	train
Reactors were covered with aluminum foil to avoid light exposure.	Reactors,0,8,engineered	"[{""token"": ""Reactors"", ""start_span"": 0, ""end_span"": 8, ""type"": ""engineered""}]"	train
Methods Sample description The coring station for ARA02B / 01A - GC ( i. e., Core GC1; 7337. 89N, 16630. 98W) was located at the Chukchi Sea continental shelf and carefully selected by both detailed bathymetric mapping and sub - bottom profiling ( Parasound).	coring station,31,45,engineered	"[{""token"": ""coring station"", ""start_span"": 31, ""end_span"": 45, ""type"": ""engineered""}]"	train
Subsequently, mRNA transcripts were mapped against all ORFs to identify functions that were highly expressed by the community during steady - state bioreactor operation ( Supplementary Data 2).	bioreactor,148,158,engineered	"[{""token"": ""bioreactor"", ""start_span"": 148, ""end_span"": 158, ""type"": ""engineered""}]"	train
The presence of hydrogenotrophic methanogens in the inoculum improves methane gas production in microbial electrolysis cells High current densities in microbial electrolysis cells ( MECs) result from the predominance of various Geobacter species on the anode, but it is not known if archaeal communities similarly converge to one specific genus.	microbial electrolysis,96,118,engineered	"[{""token"": ""microbial electrolysis"", ""start_span"": 96, ""end_span"": 118, ""type"": ""engineered""}]"	train
A fixed voltage of 0. 7 V was applied to all reactors.	reactors,45,53,engineered	"[{""token"": ""reactors"", ""start_span"": 45, ""end_span"": 53, ""type"": ""engineered""}]"	train
Details of the MFC design and operation are described in the study of Molognoni et al. ( 2014).	MFC,15,18,engineered	"[{""token"": ""MFC"", ""start_span"": 15, ""end_span"": 18, ""type"": ""engineered""}]"	train
Mesophilic versus thermophilic anaerobic digestion of cattle manure: methane productivity and microbial ecology In this study, productivity and physicochemical and microbiological ( 454 sequencing) parameters, as well as environmental criteria, were investigated in anaerobic reactors to contribute to the ongoing debate about the optimal temperature range for treating animal manure, and expand the general knowledge on the relation between microbiological and physicochemical process indicators.	reactors,276,284,engineered	"[{""token"": ""reactors"", ""start_span"": 276, ""end_span"": 284, ""type"": ""engineered""}]"	train
