Sentence	entity_1	json	split
For example, genes encoding proteins involved in folate biosynthesis [ 40] were upregulated, suggesting that certain cofactors that may be necessary during adherence were unavailable.	folate,49,55,Chemical	"[{""token"": ""folate"", ""start_span"": 49, ""end_span"": 55, ""type"": ""Chemical""}]"	train
Also upregulated were genes encoding subunits of the F0F1 ATPase [ 41] ( discussed in more detail later), which may indicate an acid stress response to maintain cytoplasmic pH or a need to generate ATP in response to increased energy requirements.	ATP,58,61,Chemical	"[{""token"": ""ATP"", ""start_span"": 58, ""end_span"": 61, ""type"": ""Chemical""}]"	train
However, despite a rigorous statistical approach, this analysis, like many previous microarray studies, identified the differential expression of a large number of unknown genes ( n = 21) and a number of incomplete biological pathways ( e. g., F0F1 ATPase [ 41] and folate biosynthesis [ 40]) by failing to detect the differential expression of a number of known gene pathway members ( Table 1).	folate,266,272,Chemical	"[{""token"": ""folate"", ""start_span"": 266, ""end_span"": 272, ""type"": ""Chemical""}]"	train
For example, we initially identified ( Table 1) the significant upregulation of three of the five known gene members of the folate biosynthetic pathway [ 40] ( spy1096 - 1100), but GenomeCrawler identified a significant cluster containing all five genes ( Table 3 and Figure 2B).	folate,124,130,Chemical	"[{""token"": ""folate"", ""start_span"": 124, ""end_span"": 130, ""type"": ""Chemical""}]"	train
Earlier studies by the authors showed that FimA expression was modulated by environmental cues, including temperature and hemin concentration, and by the presence of Streptococcus cristatus, an early colonizer of dental plaque ( Xie et al., 1997, 2000b).	hemin,122,127,Chemical	"[{""token"": ""hemin"", ""start_span"": 122, ""end_span"": 127, ""type"": ""Chemical""}]"	train
However, no apparent difference was found in DNA - binding affinity between rFimRs with or without acetyl phosphate treatment.	acetyl phosphate,99,115,Chemical	"[{""token"": ""acetyl phosphate"", ""start_span"": 99, ""end_span"": 115, ""type"": ""Chemical""}]"	train
In E. coli, two promoters direct transcription of acs encoding, an acetate - scavenging enzyme required for fitness during periods of carbon starvation - the distal acsP1 and the proximal acsP2 ( Beatty et al., 2003).	acetate,67,74,Chemical	"[{""token"": ""acetate"", ""start_span"": 67, ""end_span"": 74, ""type"": ""Chemical""}]"	train
This technique has previously permitted single nucleotide polymorphisms ( SNPs) of a PA - 824 drug resistant mutant strain of H37Rv to be detected [ 13].	PA - 824,85,93,Chemical	"[{""token"": ""PA - 824"", ""start_span"": 85, ""end_span"": 93, ""type"": ""Chemical""}]"	train
Among the genes expressed at low level in the phoP - ko strain and in H37Ra were several that are involved in lipid metabolism; for example, the polyketide synthases pks2 ( rv3825c) or the Pks - associated protein papA1 ( rv3824c).	polyketide,145,155,Chemical	"[{""token"": ""polyketide"", ""start_span"": 145, ""end_span"": 155, ""type"": ""Chemical""}]"	train
In addition, NirA ( Rv2391), a putative nitrite reductase and MmpL10 - FadD21 ( Rv1183 - 85c), which were all identified by TraSH analysis as potentially implicated in virulence [ 16], seem to be regulated by PhoP [ 12, 21].	nitrite,40,47,Chemical	"[{""token"": ""nitrite"", ""start_span"": 40, ""end_span"": 47, ""type"": ""Chemical""}]"	train
However, upregulation of phoP and rv3614c - rv3616c was observed after incubation of M. tuberculosis in 5mM H2O2 [ 37].	H2O2,108,112,Chemical	"[{""token"": ""H2O2"", ""start_span"": 108, ""end_span"": 112, ""type"": ""Chemical""}]"	train
Proteins belonging to the class of two - component regulatory systems, quorum sensing, universal stress proteins, and c - di - GMP signalling have been analysed.	c - di - GMP,118,130,Chemical	"[{""token"": ""c - di - GMP"", ""start_span"": 118, ""end_span"": 130, ""type"": ""Chemical""}]"	train
In P. luminescens, this TCS controls the expression of the pbgPE operon which is involved in lipid A modification and thus plays a role in colonization and infection of the invertebrate hosts [ 18, 31].	lipid A,93,100,Chemical	"[{""token"": ""lipid A"", ""start_span"": 93, ""end_span"": 100, ""type"": ""Chemical""}]"	train
Regulation by AHL - LuxR - like receptors Virulence, bioluminescence, mutualism, antibiotic production and biofilm formation are often regulated by LuxI / LuxR quorum sensing systems in Gram - negative bacteria.	AHL,14,17,Chemical	"[{""token"": ""AHL"", ""start_span"": 14, ""end_span"": 17, ""type"": ""Chemical""}]"	train
These AHLs are produced by an autoinductor synthase named LuxI.	AHLs,6,10,Chemical	"[{""token"": ""AHLs"", ""start_span"": 6, ""end_span"": 10, ""type"": ""Chemical""}]"	train
It is not known if this receptor also binds the AHLs produced by YenI.	AHLs,48,52,Chemical	"[{""token"": ""AHLs"", ""start_span"": 48, ""end_span"": 52, ""type"": ""Chemical""}]"	train
In the genome of P. luminescens, two genes encoding putative AHL - LuxR - like receptors, plu0320 and plu4562, but no luxI genes are present ( Fig. 3).	AHL,61,64,Chemical	"[{""token"": ""AHL"", ""start_span"": 61, ""end_span"": 64, ""type"": ""Chemical""}]"	train
This suggests that P. luminescens does not produce its own AHL signalling molecule, but might be able to sense those produced by other bacteria and therefore to detect mixed microbial communities as demonstrated for Salmonella enterica and Escherichia coli [ 35 - 37].	AHL,59,62,Chemical	"[{""token"": ""AHL"", ""start_span"": 59, ""end_span"": 62, ""type"": ""Chemical""}]"	train
It is interesting to note that Sodalis glossinidius strain morsitans, an endosymbiont of the tse tse fly Glossina morsitans morsitans [ 38], also has two pontential AHL - LuxR receptors, SG1740 and SG0285, but no luxI homologue ( Fig. 3).	AHL,165,168,Chemical	"[{""token"": ""AHL"", ""start_span"": 165, ""end_span"": 168, ""type"": ""Chemical""}]"	train
Regulation by AI - 2	AI - 2,14,20,Chemical	"[{""token"": ""AI - 2"", ""start_span"": 14, ""end_span"": 20, ""type"": ""Chemical""}]"	train
Beside AHL, other putative quorum sensing signalling molecules have been identified.	AHL,7,10,Chemical	"[{""token"": ""AHL"", ""start_span"": 7, ""end_span"": 10, ""type"": ""Chemical""}]"	train
It has been shown that the luxS pathway negatively controls the expression of genes for carbapenem antibiotic biosynthesis in P. luminescens [ 41].	carbapenem,88,98,Chemical	"[{""token"": ""carbapenem"", ""start_span"": 88, ""end_span"": 98, ""type"": ""Chemical""}]"	train
Overall, more than 300 AI - 2 regulated genes involved in regulation, metabolic activity, stress response and pathogenicity are known in P. luminescens [ 42].	AI - 2,23,29,Chemical	"[{""token"": ""AI - 2"", ""start_span"": 23, ""end_span"": 29, ""type"": ""Chemical""}]"	train
Homologues of these proteins are present in Y. enterocolitica ( see chapter 2), suggesting their possible regulation by AI - 2 also in this bacterium.	AI - 2,120,126,Chemical	"[{""token"": ""AI - 2"", ""start_span"": 120, ""end_span"": 126, ""type"": ""Chemical""}]"	train
Taken together, a similar and AI - 2 dependent mechanism for the regulation of insect colonization and insect pathogenicity might be used by both organisms.	AI - 2,30,36,Chemical	"[{""token"": ""AI - 2"", ""start_span"": 30, ""end_span"": 36, ""type"": ""Chemical""}]"	train
35 of these potential LuxR - like receptors exhibit PAS _ 4 signal binding domains instead of an AHL - binding domain, and two have a signalling domain with a yet unidentified motif ( Fig. 3).	AHL,97,100,Chemical	"[{""token"": ""AHL"", ""start_span"": 97, ""end_span"": 100, ""type"": ""Chemical""}]"	train
The methoprene - tolerant gene ( met, also called Resistance to Juvenile Hormone Rst1JH) of D. melanogaster encodes a helix - loop - helix transcriptional regulator combined with a PAS _ 3 domain [ 45].	methoprene,4,14,Chemical	"[{""token"": ""methoprene"", ""start_span"": 4, ""end_span"": 14, ""type"": ""Chemical""}]"	train
Regulation via c - di - GMP as a second messenger	c - di - GMP,15,27,Chemical	"[{""token"": ""c - di - GMP"", ""start_span"": 15, ""end_span"": 27, ""type"": ""Chemical""}]"	train
In addition to phenotypes that affect virulence properties indirectly, c - di - GMP can also directly regulate virulence factors [ 56, 57].	c - di - GMP,71,83,Chemical	"[{""token"": ""c - di - GMP"", ""start_span"": 71, ""end_span"": 83, ""type"": ""Chemical""}]"	train
Proteins containing a so - called GGDEF domain are responsible for the synthesis of c - di - GMP, and those with a so - called EAL domain for its degradation.	c - di - GMP,84,96,Chemical	"[{""token"": ""c - di - GMP"", ""start_span"": 84, ""end_span"": 96, ""type"": ""Chemical""}]"	train
The expression and activity of those GGDEF and EAL domain containing proteins is regulated by factors with a PilZ domain that binds c - di - GMP.	c - di - GMP,132,144,Chemical	"[{""token"": ""c - di - GMP"", ""start_span"": 132, ""end_span"": 144, ""type"": ""Chemical""}]"	train
The protein AdrA ( YE3010, GGDEF domain) is annotated as a putative diguanylate cyclase, YE2278 ( GGDEF + EAL) as a putative phosphodiesterase, YE3818 ( GGDEF) as a putative regulator, and YE3806 ( GGDEF + EAL) as a putative exported protein.	diguanylate,68,79,Chemical	"[{""token"": ""diguanylate"", ""start_span"": 68, ""end_span"": 79, ""type"": ""Chemical""}]"	train
The presence of c - di - GMP mediated regulation in Y. enterocolitica is therefore suggested to play a central role in switching from biofilm formation to the human as well as to the insect environment.	c - di - GMP,16,28,Chemical	"[{""token"": ""c - di - GMP"", ""start_span"": 16, ""end_span"": 28, ""type"": ""Chemical""}]"	train
This phenomenon is quite surprising, because with few exceptions such as Helicobacter pylori, nearly all pathogenic bacteria use c - di - GMP as a second messenger.	c - di - GMP,129,141,Chemical	"[{""token"": ""c - di - GMP"", ""start_span"": 129, ""end_span"": 141, ""type"": ""Chemical""}]"	train
The lack of these protein domains in P. luminescens reveals that c - di - GMP signalling plays a major role in pathogenic bacteria when colonizing a mammalian host, and a minor for invertebrate colonization of entomopathogenic or entomoinfecting bacteria.	c - di - GMP,65,77,Chemical	"[{""token"": ""c - di - GMP"", ""start_span"": 65, ""end_span"": 77, ""type"": ""Chemical""}]"	train
These extracellular toxins target red blood cells to provide access to iron, but often show activity against immune cells, thus contributing to the bacterial response to the immune system of hosts, including phagocytosis by insect blood cells [ 64].	iron,71,75,Chemical	"[{""token"": ""iron"", ""start_span"": 71, ""end_span"": 75, ""type"": ""Chemical""}]"	train
P. luminescens and Y. enterocolitica TPS systems include the calcium - independent hemolysin PhlA that is transported through the outer membrane and activated by PhlB.	calcium,61,68,Chemical	"[{""token"": ""calcium"", ""start_span"": 61, ""end_span"": 68, ""type"": ""Chemical""}]"	train
Remarkably, their expression is induced by low iron concentration as encountered in the insect host, and phlA / phlB are up - regulated at 18degreesC compared to 28degreesC in Y. ruckeri [ 66].	iron,47,51,Chemical	"[{""token"": ""iron"", ""start_span"": 47, ""end_span"": 51, ""type"": ""Chemical""}]"	train
In contrast, P. luminescens produces several factors involved in host cell interaction without homologues in Y. enterocolitica, namely Plu2096 which is similar to lectin PA - I, Plu1561 with strong homology to a Ca2 + dependent adhesion molecule, the adhesin Plu2433 similar to a virulence factor of the Gram - negative plant pathogen Erwinia carotovora, EvF, which is involved in colonisation of the D. melanogaster gut epithelium [ 80], and the putative invasin Plu2064.	Ca2 +,212,217,Chemical	"[{""token"": ""Ca2 +"", ""start_span"": 212, ""end_span"": 217, ""type"": ""Chemical""}]"	train
Furthermore, we found homologues of the Y. enterocolitica low - calcium - response genes ( lcrH, lcrV, and lrcD) in P. luminescens ( plu3757, plu3758, sctV) which further supports this hypothesis.	calcium,64,71,Chemical	"[{""token"": ""calcium"", ""start_span"": 64, ""end_span"": 71, ""type"": ""Chemical""}]"	train
Ymt is essential for flea colonization by Y. pestis and is regulated by AHL both in Y. pestis [ 95] and P. luminescens ( R. Heermann, unpublished data), indicating that Ymt is also required for insect colonization by P. luminescens.	AHL,72,75,Chemical	"[{""token"": ""AHL"", ""start_span"": 72, ""end_span"": 75, ""type"": ""Chemical""}]"	train
Examples are the ten triacylglycerol lipases of P. luminescens or the three identified lipases of Y. enterocolitica.	triacylglycerol,21,36,Chemical	"[{""token"": ""triacylglycerol"", ""start_span"": 21, ""end_span"": 36, ""type"": ""Chemical""}]"	train
Y. enterocolitica carries the genes encoding tetrathionate reductase ( ttrABC) and the TCS TtrRS ( YE1613 - 1617).	tetrathionate,45,58,Chemical	"[{""token"": ""tetrathionate"", ""start_span"": 45, ""end_span"": 58, ""type"": ""Chemical""}]"	train
The uhpABC operon as well as mgtC encoding the Mg2 + transport ATPase subunit have been found to be induced at low temperature in Y. enterocolitica [ 67], indicating a relevance for these metabolic genes for P. luminescens and Y. enterocolitica during insect infection.	Mg2 +,47,52,Chemical	"[{""token"": ""Mg2 +"", ""start_span"": 47, ""end_span"": 52, ""type"": ""Chemical""}]"	train
Furthermore, both insecticidal bacteria produce a chitin - binding - like protein ( Plu2352, YE3576), but chitinase - like proteins ( Plu2235, Plu2458 and Plu2461) are without homologues in Y. enterocolitica.	chitin,50,56,Chemical	"[{""token"": ""chitin"", ""start_span"": 50, ""end_span"": 56, ""type"": ""Chemical""}]"	train
Iron uptake	Iron,0,4,Chemical	"[{""token"": ""Iron"", ""start_span"": 0, ""end_span"": 4, ""type"": ""Chemical""}]"	train
Genes involved in the biosynthesis, transport and regulation of the siderophore yersiniabactin are clustered in the high pathogenicity island of Y. enterocolitica [ 103] and have counterparts in P. luminescens ( plu2316 - 2324).	yersiniabactin,80,94,Chemical	"[{""token"": ""yersiniabactin"", ""start_span"": 80, ""end_span"": 94, ""type"": ""Chemical""}]"	train
The proteins encoded by the P. luminescens fecIRABCDE operon are similar to the components of the E. coli Fe3 + - dicitrate transport system.	Fe3 +,106,111,Chemical	"[{""token"": ""Fe3 +"", ""start_span"": 106, ""end_span"": 111, ""type"": ""Chemical""}]"	train
Furthermore, P. luminescens encodes two putative heme - binding hemopexin - like proteins, the photopexins PpxA ( Plu4242) and PpxB ( Plu4243), which are the first hemopexins found in bacteria.	heme,49,53,Chemical	"[{""token"": ""heme"", ""start_span"": 49, ""end_span"": 53, ""type"": ""Chemical""}]"	train
It is suggested that the photopexins may be used by P. luminescens to scavenge iron containing compounds from insects [ 105].	iron,79,83,Chemical	"[{""token"": ""iron"", ""start_span"": 79, ""end_span"": 83, ""type"": ""Chemical""}]"	train
It also indicates that iron acquisition is a prerequisite for the infection process of pathogenic bacteria not only in mammalian, but also in invertebrate hosts, and underlines the suggestion that genetic determinants of invertebrate pathogens such as P. luminescens include the progenitors of virulence factors against vertebrates [ 79, 106].	iron,23,27,Chemical	"[{""token"": ""iron"", ""start_span"": 23, ""end_span"": 27, ""type"": ""Chemical""}]"	train
It controls the expression of the tctCBA operon encoding the tricarboxylic acid transport system TctCBA [ 107].	tricarboxylic acid,61,79,Chemical	"[{""token"": ""tricarboxylic acid"", ""start_span"": 61, ""end_span"": 79, ""type"": ""Chemical""}]"	train
The specific up - regulation of the tricarboxylic acid cycle ( TCA) enzymes within a host has also been described for other microorganisms.	tricarboxylic acid,36,54,Chemical	"[{""token"": ""tricarboxylic acid"", ""start_span"": 36, ""end_span"": 54, ""type"": ""Chemical""}]"	train
Therefore, it is obvious that Y. enterocolitica and P. luminescens use different sensing and utilization strategies for tricarboxylates.	tricarboxylates,120,135,Chemical	"[{""token"": ""tricarboxylates"", ""start_span"": 120, ""end_span"": 135, ""type"": ""Chemical""}]"	train
Another example that might enlighten the evolution of bacterial pathogenicity is the plasticity zone ( PZ) of Y. enterocolitica, a 199 kb key locus for high pathogenicity that includes YAPIYe, secretion systems, hydrogenase loci essential for gut colonization of S. typhimurium and H. pylori [ 122], and iron acquisition systems.	iron,304,308,Chemical	"[{""token"": ""iron"", ""start_span"": 304, ""end_span"": 308, ""type"": ""Chemical""}]"	train
Only few other genes or operons of the PZ are also present in P. luminescens, namely a chitinase, two iron acquisition systems, and three ysa genes, thus confirming the idea of a patchwork of horizontally acquired genes within the PZ [ 23].	iron,102,106,Chemical	"[{""token"": ""iron"", ""start_span"": 102, ""end_span"": 106, ""type"": ""Chemical""}]"	train
Dissecting the genomes of Y. enterocolitica and P. luminescens for putative key regulators, we identified factor groups ( AI - 2, PAS - 4 / LuxR like receptors) possibly involved in pathogen - insect association only, those with members contributing to either insect or mammalian pathogenicity ( QS, TKS, Usp), and c - di - GMP signalling probably not involved in regulation of activities against insects.	c - di - GMP,315,327,Chemical	"[{""token"": ""c - di - GMP"", ""start_span"": 315, ""end_span"": 327, ""type"": ""Chemical""}]"	train
One such mechanism is based upon modification of phospholipids in the cytoplasmic membrane by introducing a positively charged lysyl group into anionic phosphatidylglycerol by the MprF protein, thereby neutralizing the net charge of the membrane surface [ 11, 12].	phosphatidylglycerol,152,172,Chemical	"[{""token"": ""phosphatidylglycerol"", ""start_span"": 152, ""end_span"": 172, ""type"": ""Chemical""}]"	train
A similar reaction is mediated by products of the dltABCD operon, which are responsible for attachment of positively charged D - alanine residues into negatively charged phosphate groups in the backbone of teichoic acids [ 7, 9].	teichoic acids,206,220,Chemical	"[{""token"": ""teichoic acids"", ""start_span"": 206, ""end_span"": 220, ""type"": ""Chemical""}]"	train
Accordingly, graRS have previously been implicated in regulation of vancomycin intermediary resistance [ 14].	vancomycin,68,78,Chemical	"[{""token"": ""vancomycin"", ""start_span"": 68, ""end_span"": 78, ""type"": ""Chemical""}]"	train
The graRS mutant bound significantly more cytochrome c than the WT or the complemented mutant ( Fig. 1A), which is in accordance with the recently described reduced content of D - alanine residues in the teichoic acids of the mutant [ 10].	teichoic acids,204,218,Chemical	"[{""token"": ""teichoic acids"", ""start_span"": 204, ""end_span"": 218, ""type"": ""Chemical""}]"	train
This finding indicates that the increased binding of cytochrome c by the graRS mutant is due to decreased alanylation of teichoic acids and that the resulting surface charge alteration does not result from other regulatory effects mediated by GraRS.	teichoic acids,121,135,Chemical	"[{""token"": ""teichoic acids"", ""start_span"": 121, ""end_span"": 135, ""type"": ""Chemical""}]"	train
The amounts of LPG from WT and graRS mutant were indistinguishable ( data not shown), which corroborates recent findings that mprF is not among the graRS - regulated genes in S. aureus SA113 [ 10].	LPG,15,18,Chemical	"[{""token"": ""LPG"", ""start_span"": 15, ""end_span"": 18, ""type"": ""Chemical""}]"	train
Flow cytometry analysis suggested that although PMN was detected in the lower well consisted of IL - 8 and severe invasive GAS, but most of them were dead as defined by propidium iodine staining ( p = 0. 016) ( Figure 2A and 2C) demonstrating that severe invasive GAS affected survival of PMN and its migration activity in a transwell system.	propidium iodine,169,185,Chemical	"[{""token"": ""propidium iodine"", ""start_span"": 169, ""end_span"": 185, ""type"": ""Chemical""}]"	train
PMN death was induced shortly after encounter with severe invasive GAS, and PMN were not in apoptotic death because of low frequency of cells positive for annexin V ( data not shown), which was seen in the case of cytolysin - dependent cell injury [ 15].	cytolysin,214,223,Chemical	"[{""token"": ""cytolysin"", ""start_span"": 214, ""end_span"": 223, ""type"": ""Chemical""}]"	train
GAS produce two cytolysins that may contribute to pathogenesis.	cytolysins,16,26,Chemical	"[{""token"": ""cytolysins"", ""start_span"": 16, ""end_span"": 26, ""type"": ""Chemical""}]"	train
Figure 3A shows that PMN killing by invasive GAS was blocked by anti - SLO Ab in culture medium within lower wells of a transwell system ( p = 0. 018 compared with control Ig), at similar extent by adding free cholesterol in the medium ( data not shown).	cholesterol,210,221,Chemical	"[{""token"": ""cholesterol"", ""start_span"": 210, ""end_span"": 221, ""type"": ""Chemical""}]"	train
SLO is a cholesterol - binding pore - forming hemolysin as well as cytotoxic for other cells [ 15].	cholesterol,9,20,Chemical	"[{""token"": ""cholesterol"", ""start_span"": 9, ""end_span"": 20, ""type"": ""Chemical""}]"	train
Alginate production has been shown to inhibit phagocytic killing of Pseudomonas, to protect from antibiotic exposure [ 13], [ 14], and is associated with poor prognosis for the infected patients [ 15], [ 16].	Alginate,0,8,Chemical	"[{""token"": ""Alginate"", ""start_span"": 0, ""end_span"": 8, ""type"": ""Chemical""}]"	train
The direct observation of P. aeruginosa microcolonies encased in an alginate matrix in microscopy studies of CF bronchial samples [ 17], along with a large body of additional in vitro and in vivo data [ 7], [ 18] - [ 21] suggests that P. aeruginosa forms biofilms in the lungs of CF patients.	alginate,68,76,Chemical	"[{""token"": ""alginate"", ""start_span"": 68, ""end_span"": 76, ""type"": ""Chemical""}]"	train
The rate of diffusion through the matrix is presumably dependent on binding of the antibiotic molecules to the EPS matrix.	EPS,111,114,Chemical	"[{""token"": ""EPS"", ""start_span"": 111, ""end_span"": 114, ""type"": ""Chemical""}]"	train
CAPs are short, amphipathic peptides that bind to and disrupt both the outer and cytoplasmic membranes resulting in cell death.	CAPs,0,4,Chemical	"[{""token"": ""CAPs"", ""start_span"": 0, ""end_span"": 4, ""type"": ""Chemical""}]"	train
The broad - spectrum antimicrobial activity of CAPs against Gram - negative and Gram - positive bacteria accounts for their role as an essential component of the innate immune response of humans, animals and insects.	CAPs,47,51,Chemical	"[{""token"": ""CAPs"", ""start_span"": 47, ""end_span"": 51, ""type"": ""Chemical""}]"	train
The extracellular matrix of P. aeruginosa biofilms includes extracellular DNA [ 50], [ 51], multiple bacterial exopolysaccharides and host proteins [ 4], [ 52].	exopolysaccharides,111,129,Chemical	"[{""token"": ""exopolysaccharides"", ""start_span"": 111, ""end_span"": 129, ""type"": ""Chemical""}]"	train
This property, in combination with the fast - killing observed in response to extracellular DNA led us to hypothesize that addition of exogenous DNA resulted in the loss of membrane integrity through cation chelation, in a manner similar to that observed with the known cation chelator EDTA [ 58].	EDTA,286,290,Chemical	"[{""token"": ""EDTA"", ""start_span"": 286, ""end_span"": 290, ""type"": ""Chemical""}]"	train
EDTA treatment of cells resulted in chelation and removal of divalent cations from the OM, leading to disruption of the OM [ 58].	EDTA,0,4,Chemical	"[{""token"": ""EDTA"", ""start_span"": 0, ""end_span"": 4, ""type"": ""Chemical""}]"	train
EDTA, the known cation chelator caused comparable IM and OM perturbations as those observed in cells exposed to extracellular DNA.	EDTA,0,4,Chemical	"[{""token"": ""EDTA"", ""start_span"": 0, ""end_span"": 4, ""type"": ""Chemical""}]"	train
PI staining also revealed the presence of long strands of genomic DNA, presumably as a consequence of the loss of membrane integrity, cell lysis and release of cytoplasmic contents, including DNA ( Fig 2B).	PI,0,2,Chemical	"[{""token"": ""PI"", ""start_span"": 0, ""end_span"": 2, ""type"": ""Chemical""}]"	train
Pseudomonas specific semi - quantitative PCR ( qPCR) was also performed to confirm that the DNA released following DNA or EDTA treated cells was in fact genomic DNA from P. aeruginosa ( Fig 2C).	EDTA,122,126,Chemical	"[{""token"": ""EDTA"", ""start_span"": 122, ""end_span"": 126, ""type"": ""Chemical""}]"	train
Only partial restoration of growth was observed in the presence of Zn2 + ( Fig 3B).	Zn2 +,67,72,Chemical	"[{""token"": ""Zn2 +"", ""start_span"": 67, ""end_span"": 72, ""type"": ""Chemical""}]"	train
Cations play diverse physiologically important roles within a cell; from detoxification of reactive oxygen species and co - factors for enzymes to the stabilization of macromolecules within the cell [ 62].	reactive oxygen species,91,114,Chemical	"[{""token"": ""reactive oxygen species"", ""start_span"": 91, ""end_span"": 114, ""type"": ""Chemical""}]"	train
Extracellular DNA induces expression of the PA3552 - PA3559 CAP resistance operon in planktonic cultures	CAP,60,63,Chemical	"[{""token"": ""CAP"", ""start_span"": 60, ""end_span"": 63, ""type"": ""Chemical""}]"	train
In P. aeruginosa, the PhoPQ and PmrAB - controlled response to magnesium limitation includes the induction of the PA3552 and its neighbouring genes.	magnesium,63,72,Chemical	"[{""token"": ""magnesium"", ""start_span"": 63, ""end_span"": 72, ""type"": ""Chemical""}]"	train
The genes PA3552 - PA3559 are co - regulated under low Mg2 + conditions and are thought to be organized as an operon [ 45] - [ 47].	Mg2 +,55,60,Chemical	"[{""token"": ""Mg2 +"", ""start_span"": 55, ""end_span"": 60, ""type"": ""Chemical""}]"	train
Induction of the CAP resistance operon was dose - dependent with increasing DNA concentrations up to 0. 5% ( w / v) DNA, at which growth is inhibited ( Fig 4A).	CAP,17,20,Chemical	"[{""token"": ""CAP"", ""start_span"": 17, ""end_span"": 20, ""type"": ""Chemical""}]"	train
Addition of excess Mg2 + ( 5 mM) to the growth medium completely repressed the expression of PA3553 in cultures supplemented with DNA, except at the highest DNA concentration tested ( 0. 5% ( w / v)) ( Fig 4B).	Mg2 +,19,24,Chemical	"[{""token"": ""Mg2 +"", ""start_span"": 19, ""end_span"": 24, ""type"": ""Chemical""}]"	train
Thus, the ability of extracellular DNA to chelate magnesium is independent of origin and molecular weight, indicating that chelation is a general property of this negatively charged polymer.	magnesium,50,59,Chemical	"[{""token"": ""magnesium"", ""start_span"": 50, ""end_span"": 59, ""type"": ""Chemical""}]"	train
This is due to the addition of excess Mg2 + ions as part of the DNAse buffer, which is required for DNAse activity.	Mg2 +,38,43,Chemical	"[{""token"": ""Mg2 +"", ""start_span"": 38, ""end_span"": 43, ""type"": ""Chemical""}]"	train
Expression of the CAP resistance operon PA3552 - PA3559 is induced in biofilms in response to extracellular DNA	CAP,18,21,Chemical	"[{""token"": ""CAP"", ""start_span"": 18, ""end_span"": 21, ""type"": ""Chemical""}]"	train
To determine the influence of extracellular DNA on PA3553 gene expression in biofilms, DNA - enriched biofilms were cultivated on the surface of polystyrene pegs.	polystyrene,145,156,Chemical	"[{""token"": ""polystyrene"", ""start_span"": 145, ""end_span"": 156, ""type"": ""Chemical""}]"	train
One - day old PA3553:: lux biofilms were washed to remove non - adhered cells and gene expression was measured from the cells adhered to the polystyrene peg surface.	polystyrene,141,152,Chemical	"[{""token"": ""polystyrene"", ""start_span"": 141, ""end_span"": 152, ""type"": ""Chemical""}]"	train
In biofilms cultivated in the presence of extracellular DNA supplemented with excess Mg2 + ( 5 mM), PA3553 gene expression was completely repressed ( data not shown).	Mg2 +,85,90,Chemical	"[{""token"": ""Mg2 +"", ""start_span"": 85, ""end_span"": 90, ""type"": ""Chemical""}]"	train
The concentration of Mg2 + that bound to the column in the absence of DNA is indicated.	Mg2 +,21,26,Chemical	"[{""token"": ""Mg2 +"", ""start_span"": 21, ""end_span"": 26, ""type"": ""Chemical""}]"	train
We have shown previously that the PA3552 - PA3559 operon is required for resistance to cationic antimicrobial peptides in planktonic cultures grown in limiting magnesium conditions [ 47].	magnesium,160,169,Chemical	"[{""token"": ""magnesium"", ""start_span"": 160, ""end_span"": 169, ""type"": ""Chemical""}]"	train
The PA3553 mutant also displayed decreased DNA - induced resistance to aminoglycosides compared to PAO1.	aminoglycosides,71,86,Chemical	"[{""token"": ""aminoglycosides"", ""start_span"": 71, ""end_span"": 86, ""type"": ""Chemical""}]"	train
Biofilms that were exposed to DNA during either the cultivation or challenge stages only, showed similar resistance profiles to biofilms grown and challenged in magnesium - replete conditions ( Tables 1 - 2).	magnesium,161,170,Chemical	"[{""token"": ""magnesium"", ""start_span"": 161, ""end_span"": 170, ""type"": ""Chemical""}]"	train
We have identified a novel mechanism of biofilm - associated antibiotic resistance in which the presence of DNA in the extracellular matrix of biofilms creates a localized cation - limited environment that is detected by P. aeruginosa leading to the induction of LPS modification genes and resistance to antimicrobials.	LPS,263,266,Chemical	"[{""token"": ""LPS"", ""start_span"": 263, ""end_span"": 266, ""type"": ""Chemical""}]"	train
As an intracellular pathogen, the PhoPQ system of Salmonella typhimurium is activated by limiting magnesium in vitro and phoP - regulated genes are also induced after invasion of macrophages and epithelial cells [ 65].	magnesium,98,107,Chemical	"[{""token"": ""magnesium"", ""start_span"": 98, ""end_span"": 107, ""type"": ""Chemical""}]"	train
These observations suggested that Mg2 + is limiting within host cells, but it was recently shown that vacuole acidification and low pH is the crucial environmental trigger of PhoPQ activation [ 66].	Mg2 +,34,39,Chemical	"[{""token"": ""Mg2 +"", ""start_span"": 34, ""end_span"": 39, ""type"": ""Chemical""}]"	train
Many extracellular pathogens possess homologs of the cation - sensing PhoPQ TCS that responds to magnesium limitation and induces genes necessary for surviving this environmental challenge [ 65].	magnesium,97,106,Chemical	"[{""token"": ""magnesium"", ""start_span"": 97, ""end_span"": 106, ""type"": ""Chemical""}]"	train
PhoQ mutants, which constitutively express phoP and are constitutively resistant to cationic antimicrobial peptides, are also more resistant to aminoglycosides [ 43].	aminoglycosides,144,159,Chemical	"[{""token"": ""aminoglycosides"", ""start_span"": 144, ""end_span"": 159, ""type"": ""Chemical""}]"	train
This coincides with the localization of a CAP - tolerant subpopulation of bacteria that expresses the PA3552 - PA3559 operon along the surface of mushroom - structured P. aeruginosa biofilms [ 49].	CAP,42,45,Chemical	"[{""token"": ""CAP"", ""start_span"": 42, ""end_span"": 45, ""type"": ""Chemical""}]"	train
However, our data indicates that the presence of DNA in biofilms does indeed result in a cation - limited environment, resulting in the induction of the LPS modification operon PA3552 - PA3559.	LPS,153,156,Chemical	"[{""token"": ""LPS"", ""start_span"": 153, ""end_span"": 156, ""type"": ""Chemical""}]"	train
Our observation that DNA imposes a cation gradient in biofilm is also consistent with previous reports of oxygen and nutrient gradients within biofilms, which result in diverse physiological cellular states within a biofilm community [ 72].	oxygen,106,112,Chemical	"[{""token"": ""oxygen"", ""start_span"": 106, ""end_span"": 112, ""type"": ""Chemical""}]"	train
It has previously been reported that Mg2 + concentrations within the airway surface fluid are high ( 2. 2 mM) [ 73], [ 74].	Mg2 +,37,42,Chemical	"[{""token"": ""Mg2 +"", ""start_span"": 37, ""end_span"": 42, ""type"": ""Chemical""}]"	train
However, induction of PA3553 gene expression does not occur in the presence of alginate ( data not shown).	alginate,79,87,Chemical	"[{""token"": ""alginate"", ""start_span"": 79, ""end_span"": 87, ""type"": ""Chemical""}]"	train
Furthermore, these findings indicate that DNA - rich environments, such as bacterial biofilms or the CF lung, may represent the natural setting where bacterial growth is cation limited, and highlight the importance of the PhoPQ / PmrAB controlled response and LPS modifications in antibiotic resistance in biofilms.	LPS,260,263,Chemical	"[{""token"": ""LPS"", ""start_span"": 260, ""end_span"": 263, ""type"": ""Chemical""}]"	train
The hyaluronic acid capsule and S. equi M - like protein ( SeM) are both required for the resistance to phagocytosis by PMNs [ 16 - 17].	hyaluronic acid,4,19,Chemical	"[{""token"": ""hyaluronic acid"", ""start_span"": 4, ""end_span"": 19, ""type"": ""Chemical""}]"	train
An intranasal vaccine made of live attenuated strain has been used in USA, which lacks the hyaluronic acid capsule, and various adverse effects, including pharyngeal lymphadenopathy, limb edema, and bastard strangles abscesses, have been reported [ 15].	hyaluronic acid,91,106,Chemical	"[{""token"": ""hyaluronic acid"", ""start_span"": 91, ""end_span"": 106, ""type"": ""Chemical""}]"	train
Double crossoverat both of the flanking fragments would lead to the replacement of the vicK internal fragment with the aad gene, resulting in vicK deletion strains with resistance only to spectinomycin.	spectinomycin,188,201,Chemical	"[{""token"": ""spectinomycin"", ""start_span"": 188, ""end_span"": 201, ""type"": ""Chemical""}]"	train
Salmonella regulators required for systemic mouse infection Typhimurium encodes a surfeit of regulators ( more than 330 based on annotation cited in NCBI) presumably because it can survive and replicate in many different environments, cause infection in diverse hosts, and can use multiple carbon sources and terminal electron acceptors.	carbon,290,296,Chemical	"[{""token"": ""carbon"", ""start_span"": 290, ""end_span"": 296, ""type"": ""Chemical""}]"	train
However the specific environmental signals are not known and therefore each strain was grown in four different conditions; to log phase or stationary phase in Luria - Bertani ( LB) broth and in a low pH / low magnesium, minimal medium [ 47], [ 48].	magnesium,209,218,Chemical	"[{""token"": ""magnesium"", ""start_span"": 209, ""end_span"": 218, ""type"": ""Chemical""}]"	train
Previous results have shown that a conservative replacement of the amino acid that is the essential phosphate acceptor eliminated expression of SPI - 2 genes suggesting that SsrB requires phosphorylation for activity.	phosphate,100,109,Chemical	"[{""token"": ""phosphate"", ""start_span"": 100, ""end_span"": 109, ""type"": ""Chemical""}]"	train
Mycobacterium tuberculosis Universal Stress Protein Rv2623 Regulates Bacillary Growth by ATP - Binding: Requirement for Establishing Chronic Persistent Infection	ATP,89,92,Chemical	"[{""token"": ""ATP"", ""start_span"": 89, ""end_span"": 92, ""type"": ""Chemical""}]"	train
Structure - guided mutagenesis yielded Rv2623 mutants with reduced ATP - binding capacity.	ATP,67,70,Chemical	"[{""token"": ""ATP"", ""start_span"": 67, ""end_span"": 70, ""type"": ""Chemical""}]"	train
Analysis of mycobacteria overexpressing these mutants revealed that the in vitro growth - inhibitory property of Rv2623 correlates with its ability to bind ATP.	ATP,156,159,Chemical	"[{""token"": ""ATP"", ""start_span"": 156, ""end_span"": 159, ""type"": ""Chemical""}]"	train
We propose that Rv2623 may function as an ATP - dependent signaling intermediate in a pathway that promotes persistent infection.	ATP,42,45,Chemical	"[{""token"": ""ATP"", ""start_span"": 42, ""end_span"": 45, ""type"": ""Chemical""}]"	train
The rv2623 - specific allelic exchange construct was delivered via recombinant mycobacteriophage phAE159 and transformants were analyzed by Southern blot, confirming replacement of rv2623 with the hyg gene, which confers hygromycin resistance ( Figure 1A).	hygromycin,221,231,Chemical	"[{""token"": ""hygromycin"", ""start_span"": 221, ""end_span"": 231, ""type"": ""Chemical""}]"	train
However, the in vitro growth kinetics of Deltarv2623 M. tuberculosis in OADC - supplemented Middlebrook 7H9 or minimal Sauton ' s medium is comparable to that of wildtype Erdman up to 14 days post - inoculation ( Figure 2A).	OADC,72,76,Chemical	"[{""token"": ""OADC"", ""start_span"": 72, ""end_span"": 76, ""type"": ""Chemical""}]"	train
The nucleotide - binding capacity of a subset of USPs was discovered following the observation that MJ0577, a single - domain USP from Methanococcus jannaschii, co - purifies and co - crystallizes with ATP [ 26].	ATP,202,205,Chemical	"[{""token"": ""ATP"", ""start_span"": 202, ""end_span"": 205, ""type"": ""Chemical""}]"	train
The presence of this motif in each of the two tandem USP domains of Rv2623 [ 7] raised the possibility that this protein possesses ATP binding activity.	ATP,131,134,Chemical	"[{""token"": ""ATP"", ""start_span"": 131, ""end_span"": 134, ""type"": ""Chemical""}]"	train
The crystal structure of M. tuberculosis Rv2623: Dimer assembly and ATP - binding capacity	ATP,68,71,Chemical	"[{""token"": ""ATP"", ""start_span"": 68, ""end_span"": 71, ""type"": ""Chemical""}]"	train
Each domain possesses a pair of conserved betaalphabeta motifs ( domain 1: beta1 - L1 - alpha1 - beta2, beta4 - L2 - alpha4 - beta5; domain 2: beta6 - L3 - alpha5 - beta7, beta9 - L4 - alpha8 - beta10) that encompass four loops ( designated L1 - L4) responsible for ATP recognition ( Figure 6A and C).	ATP,266,269,Chemical	"[{""token"": ""ATP"", ""start_span"": 266, ""end_span"": 269, ""type"": ""Chemical""}]"	train
"A "" U - shaped "" ATP molecule that lies within a cleft near the monomer surface is stabilized by 1) a cluster of hydrophobic residues ( I14, V41, H42, V116 / 132 / 261 / 277 / 281, L136, A175) that forge the adenine / ribose - binding scaffold, 2) a pair of conserved L1 / L3 aspartates ( D15 - L1 / D167 - L3), and 3) small phosphoryl / ribosyl - binding residues within the G - 2X - G - 9X - G ( S / T) motifs that comprise L2 / L4 ( G120 / 265 / 267 / 268 and S131 / 276) ( Figures 6A, C and 7A)."	ATP,17,20,Chemical	"[{""token"": ""ATP"", ""start_span"": 17, ""end_span"": 20, ""type"": ""Chemical""}]"	train
Dimerization of Rv2623 occurs along a 2 - fold axis orthogonal to the intramonomer dyad and juxtaposes ATP binding pockets from opposing monomers ( Figure 6B).	ATP,103,106,Chemical	"[{""token"": ""ATP"", ""start_span"": 103, ""end_span"": 106, ""type"": ""Chemical""}]"	train
This structure is nearly identical to the present model as demonstrated by superposition over the ATP ligands and the monomeric and dimeric forms ( rmsds are 0. 57 and 0. 81 for 258 and 517 matched CA ' s, respectively).	ATP,98,101,Chemical	"[{""token"": ""ATP"", ""start_span"": 98, ""end_span"": 101, ""type"": ""Chemical""}]"	train
Overlay of these structures reveals very considerable similarity for the residues that form the binding pockets and the associated ATP molecules, for which the triphosphoryl moieties assume virtually indistinguishable conformations.	ATP,131,134,Chemical	"[{""token"": ""ATP"", ""start_span"": 131, ""end_span"": 134, ""type"": ""Chemical""}]"	train
Relatively subtle structural and phylogenetic differences that exist between the ATP - binding pockets might nevertheless confer divergent binding and / or regulatory properties to the tandem domains.	ATP,81,84,Chemical	"[{""token"": ""ATP"", ""start_span"": 81, ""end_span"": 84, ""type"": ""Chemical""}]"	train
Generation and analysis of ATP - binding - deficient Rv2623 mutants	ATP,27,30,Chemical	"[{""token"": ""ATP"", ""start_span"": 27, ""end_span"": 30, ""type"": ""Chemical""}]"	train
In silico replacement of the beta4 G117 side chain hydrogen with a methyl group suggested that any residue larger than glycine at this position is likely to perturb both of the conserved loop regions in contact with the nucleotide.	hydrogen,51,59,Chemical	"[{""token"": ""hydrogen"", ""start_span"": 51, ""end_span"": 59, ""type"": ""Chemical""}]"	train
Similarly, extension of the D15 side chain to glutamate was also predicted to interfere with the ATP - binding conformation ( Figure 7A).	ATP,97,100,Chemical	"[{""token"": ""ATP"", ""start_span"": 97, ""end_span"": 100, ""type"": ""Chemical""}]"	train
The growth - regulating property of M. tuberculosis Rv2623 is dependent on its ability to bind ATP	ATP,95,98,Chemical	"[{""token"": ""ATP"", ""start_span"": 95, ""end_span"": 98, ""type"": ""Chemical""}]"	train
Results of these studies demonstrated that while overexpression of wildtype Rv2623 retards the growth of the recipient strain relative to cells transformed with vector alone, growth of the strains overexpressing ATP - binding - deficient mutant Rv2623 are only minimally affected by overexpression as assessed by spotting serial dilutions of the cultures of the appropriate strains onto solid Middlebrook 7H10 agar ( data not shown) as well as by monitoring the time to detection using the BD BACTEC 9000MB system ( Figure 8A).	ATP,212,215,Chemical	"[{""token"": ""ATP"", ""start_span"": 212, ""end_span"": 215, ""type"": ""Chemical""}]"	train
Taken together, these data strongly suggest that the ability of Rv2623 to regulate growth of M. smegmatis and M. tuberculosis is dependent on an ATP - dependent process.	ATP,145,148,Chemical	"[{""token"": ""ATP"", ""start_span"": 145, ""end_span"": 148, ""type"": ""Chemical""}]"	train
Recent transcriptional analysis of Rv2623, while confirming the essentiality of the two 18 bp palindromic DosR - binding motifs that are present in the promoter region of this gene [ 38] for induction of Rv2623 under low oxygen conditions, also demonstrated the presence of additional regulatory elements within the rv2623 5 ' - untranslated region [ 18].	oxygen,221,227,Chemical	"[{""token"": ""oxygen"", ""start_span"": 221, ""end_span"": 227, ""type"": ""Chemical""}]"	train
Putative functional differences between USPs are implied by their assignment to two subclasses: one whose members do not bind ATP and another whose constituents bind and hydrolyze adenine nucleotide substrates [ 8], [ 26], [ 27], [ 45], [ 46].	ATP,126,129,Chemical	"[{""token"": ""ATP"", ""start_span"": 126, ""end_span"": 129, ""type"": ""Chemical""}]"	train
The unique nucleotide - binding pocket of this protein family is structurally distinct from those commonly encountered in ATP - binding proteins [ 26], [ 47], [ 48].	ATP,122,125,Chemical	"[{""token"": ""ATP"", ""start_span"": 122, ""end_span"": 125, ""type"": ""Chemical""}]"	train
Specific roles for USP family proteins are just beginning to be characterized, and early functional classifications have been informed by ATP - binding capacity [ 9].	ATP,138,141,Chemical	"[{""token"": ""ATP"", ""start_span"": 138, ""end_span"": 141, ""type"": ""Chemical""}]"	train
Furthermore, given that the attenuated growth phenotype caused by overexpression of Rv2623 could be abrogated by mutations that interfere with the binding of this protein to its nucleotide substrate, it is likely that the mycobacterial growth - regulatory faculty of Rv2623 is mediated by an ATP - dependent function.	ATP,292,295,Chemical	"[{""token"": ""ATP"", ""start_span"": 292, ""end_span"": 295, ""type"": ""Chemical""}]"	train
Mechanistically, results of the mutagenesis studies have shown that Rv2623 regulates growth through ATP - dependent function.	ATP,100,103,Chemical	"[{""token"": ""ATP"", ""start_span"": 100, ""end_span"": 103, ""type"": ""Chemical""}]"	train
Clearly, much remains to be learned regarding how the ATP - dependent function of Rv2623 contributes to growth regulation.	ATP,54,57,Chemical	"[{""token"": ""ATP"", ""start_span"": 54, ""end_span"": 57, ""type"": ""Chemical""}]"	train
Experiments designed to investigate the potential ATP - hydrolyzing activity of Rv2623 are currently underway.	ATP,50,53,Chemical	"[{""token"": ""ATP"", ""start_span"": 50, ""end_span"": 53, ""type"": ""Chemical""}]"	train
Furthermore, the intracellular signaling molecule bis - ( 3 ' - 5 ') - cyclic diguanylic guanosine monophosphate ( cyclic - di - GMP), first described to control extracellular cellulose biosynthesis in Acetobacter xylinum [ 18], [ 19], has been demonstrated in several microorganisms to modulate biofilm formation via the production of exopolysaccharides or matrix components, control auto - aggregation of planktonic cells, and regulate swarming motility [ 20] - [ 32].	cyclic - di - GMP,115,132,Chemical	"[{""token"": ""cyclic - di - GMP"", ""start_span"": 115, ""end_span"": 132, ""type"": ""Chemical""}]"	train
In P. aeruginosa, at least two pathways have been identified to modulate cyclic - di - GMP and thus, biofilm formation.	cyclic - di - GMP,73,90,Chemical	"[{""token"": ""cyclic - di - GMP"", ""start_span"": 73, ""end_span"": 90, ""type"": ""Chemical""}]"	train
Both are involved in the reciprocal cyclic - di - GMP - dependent regulation of Pel and Psl exopolysaccharide production as P. aeruginosa transitions from a planktonic to a surface associated lifestyle.	cyclic - di - GMP,36,53,Chemical	"[{""token"": ""cyclic - di - GMP"", ""start_span"": 36, ""end_span"": 53, ""type"": ""Chemical""}]"	train
Inactivation of BfiS, BfmR, and MifR ( PA4197, PA4101, PA5511, respectively) did not affect initial attachment to polystyrene compared to wild type biofilms as revealed by the crystal violet microtiter plate assay and confirmed by microscopy ( not shown).	polystyrene,114,125,Chemical	"[{""token"": ""polystyrene"", ""start_span"": 114, ""end_span"": 125, ""type"": ""Chemical""}]"	train
Loss of bfiS, bfmR, and mifR expression due to arabinose removal resulted in the collapse of the mutant biofilm architecture within three days.	arabinose,47,56,Chemical	"[{""token"": ""arabinose"", ""start_span"": 47, ""end_span"": 56, ""type"": ""Chemical""}]"	train
For DeltabfiS and DeltabfmR mutant biofilms, biofilm disaggregation was noticeable as early as 24 hr post arabinose removal ( not shown).	arabinose,106,115,Chemical	"[{""token"": ""arabinose"", ""start_span"": 106, ""end_span"": 115, ""type"": ""Chemical""}]"	train
Post 144 hr of arabinose removal, the biofilm architecture of the complemented mutants was similar to mutant biofilms lacking the respective regulatory gene ( Figs. 2, 5).	arabinose,15,24,Chemical	"[{""token"": ""arabinose"", ""start_span"": 15, ""end_span"": 24, ""type"": ""Chemical""}]"	train
Crystallographic analysis of SrcA at a resolution of 2. 5 A revealed a dimer similar to the CesT chaperone from enteropathogenic E. coli but lacking a 17 - amino acid extension at the carboxyl terminus.	carboxyl,184,192,Chemical	"[{""token"": ""carboxyl"", ""start_span"": 184, ""end_span"": 192, ""type"": ""Chemical""}]"	train
These chaperones often have common physical features such as low molecular weight ( < 15 kDa), an acidic isoelectric point and a predicted amphipathic helix at the carboxyl terminus.	carboxyl,164,172,Chemical	"[{""token"": ""carboxyl"", ""start_span"": 164, ""end_span"": 172, ""type"": ""Chemical""}]"	train
Class I chaperones bind to translocated effector proteins at a chaperone binding domain ( CBD) located in the amino terminus of the effector.	amino,110,115,Chemical	"[{""token"": ""amino"", ""start_span"": 110, ""end_span"": 115, ""type"": ""Chemical""}]"	train
Interestingly, SrcA lacks 17 - amino acids that make up the carboxyl terminus of CesT, which includes Glu142, and yet it still retains effector binding, ATPase binding and effector secretion functionalities.	carboxyl,60,68,Chemical	"[{""token"": ""carboxyl"", ""start_span"": 60, ""end_span"": 68, ""type"": ""Chemical""}]"	train
In our experiments, we could induce the ATPase domain of SsaN to oligomerize in the presence of SrcA, but not in its absence, which was intriguing because the purified enzyme lacked a domain at the carboxyl terminus thought to be involved in oligomer stability, at least for E. coli EscN [ 14].	carboxyl,198,206,Chemical	"[{""token"": ""carboxyl"", ""start_span"": 198, ""end_span"": 206, ""type"": ""Chemical""}]"	train
In common with many other bacteria, ECM synthesis in Y. pestis is controlled by intracellular levels of cyclic di - GMP, which are determined by competing activities of the hmsT diguanylate cyclase and hmsP phosphodiesterase gene products [ 8], [ 9].	di - GMP,111,119,Chemical	"[{""token"": ""di - GMP"", ""start_span"": 111, ""end_span"": 119, ""type"": ""Chemical""}]"	train
Flea proteases, lipases, and other digestive enzymes begin to process the blood meal in the midgut immediately after feeding, yielding amino acids and peptides, glycerol, fatty acids, and simple carbohydrates [ 12].	glycerol,161,169,Chemical	"[{""token"": ""glycerol"", ""start_span"": 161, ""end_span"": 169, ""type"": ""Chemical""}]"	train
"This provides the "" medium "" for Y. pestis growth, but these and other factors such as pH, oxygen tension, osmolarity, and flea antibacterial immune components are poorly defined."	oxygen,91,97,Chemical	"[{""token"": ""oxygen"", ""start_span"": 91, ""end_span"": 97, ""type"": ""Chemical""}]"	train
Alternatively, the gabD and gabT gene products might act in the reverse direction to synthesize GABA, which has osmoprotective properties [ 13].	GABA,96,100,Chemical	"[{""token"": ""GABA"", ""start_span"": 96, ""end_span"": 100, ""type"": ""Chemical""}]"	train
In contrast to the amino acids, hexoses do not appear to be an important energy source during infection of the flea.	hexoses,32,39,Chemical	"[{""token"": ""hexoses"", ""start_span"": 32, ""end_span"": 39, ""type"": ""Chemical""}]"	train
Expression of the glucose PTS system was only slightly increased relative to LB cultures, and other PTS systems were downregulated ( Table S2).	glucose,18,25,Chemical	"[{""token"": ""glucose"", ""start_span"": 18, ""end_span"": 25, ""type"": ""Chemical""}]"	train
Glycolytic pathways were not upregulated in the flea; instead, available hexoses and the gluconeogenesis pathway may be used to synthesize polysaccharide components required for cell growth.	hexoses,73,80,Chemical	"[{""token"": ""hexoses"", ""start_span"": 73, ""end_span"": 80, ""type"": ""Chemical""}]"	train
Although genes in the polyamine transport gabTpotDBC locus are among the most highly induced genes in the flea ( Table S1) and polyamines are essential for Y. pestis biofilm formation [ 30], we have previously reported that a Y. pestis Deltapot mutant has no defect in flea infection or blockage [ 31].	polyamines,127,137,Chemical	"[{""token"": ""polyamines"", ""start_span"": 127, ""end_span"": 137, ""type"": ""Chemical""}]"	train
This is likely due to the fact that Y. pestis is able to synthesize polyamines de novo.	polyamines,68,78,Chemical	"[{""token"": ""polyamines"", ""start_span"": 68, ""end_span"": 78, ""type"": ""Chemical""}]"	train
In addition to the known temperature - induced virulence factors, iron acquisition systems, including the ybt and yfe operons that are required for virulence; and oxidative and nitrosative stress response genes, including the hmp virulence factor, are highly upregulated in the rat bubo, but not the flea.	iron,66,70,Chemical	"[{""token"": ""iron"", ""start_span"": 66, ""end_span"": 70, ""type"": ""Chemical""}]"	train
The PhoPQ system is induced in low Mg2 + or low pH environments, or by exposure to CAMPs [ 41], [ 42], [ 43].	Mg2 +,35,40,Chemical	"[{""token"": ""Mg2 +"", ""start_span"": 35, ""end_span"": 40, ""type"": ""Chemical""}]"	train
The Mg2 + concentration and pH of the flea digestive tract have not been defined, so the inducing stimulus is unknown, but CAMPs are induced and secreted into the gut by blood feeding insects when they take a blood meal containing bacteria [ 44], [ 45].	Mg2 +,4,9,Chemical	"[{""token"": ""Mg2 +"", ""start_span"": 4, ""end_span"": 9, ""type"": ""Chemical""}]"	train
It was shown previously that its dysfunction alters the expression of some major outer membrane proteins and the pattern of lipid A acylation.	lipid A,124,131,Chemical	"[{""token"": ""lipid A"", ""start_span"": 124, ""end_span"": 131, ""type"": ""Chemical""}]"	train
Ten genes related with carbon metabolism ( pckA and fumB among others) were up - regulated in the bvrR mutant, and denitrification genes ( nirK, norC and nosZ) were also regulated.	carbon,23,29,Chemical	"[{""token"": ""carbon"", ""start_span"": 23, ""end_span"": 29, ""type"": ""Chemical""}]"	train
In response to stimuli, the sensor kinase autophosphorylates, then transfers its phosphate to its cognate response regulator to control the transcription of target genes [ 1].	phosphate,81,90,Chemical	"[{""token"": ""phosphate"", ""start_span"": 81, ""end_span"": 90, ""type"": ""Chemical""}]"	train
BvrS is a membrane - bound homodimeric protein that has three conserved regions frequently found in members of the histidine protein kinase superfamily: an amino - terminal periplasmic sensing domain with transmembrane segments, a cytoplasmic dimerisation domain with a specific His residue, and the carboxy - terminal ATP - binding kinase domain [ 5].	ATP,319,322,Chemical	"[{""token"": ""ATP"", ""start_span"": 319, ""end_span"": 322, ""type"": ""Chemical""}]"	train
As mentioned before, phosphoenolpyruvate carboxykinase gene ( pckA, BAB1 _ 2091) which is located upstream of the regulatory gene bvrR and divergently expressed was up - regulated.	phosphoenolpyruvate,21,40,Chemical	"[{""token"": ""phosphoenolpyruvate"", ""start_span"": 21, ""end_span"": 40, ""type"": ""Chemical""}]"	train
Genes encoding proteins related to the PTS, including a HPr Ser - kinase, an EIIA permease of the mannose family and a HPr homologue precede those of the two - component regulatory system.	mannose,98,105,Chemical	"[{""token"": ""mannose"", ""start_span"": 98, ""end_span"": 105, ""type"": ""Chemical""}]"	train
According to this, it has been demonstrated that in A. tumefaciens the pckA genes is indeed under the control of ChvG / ChvI [ 16] and that null mutants in S. meliloti exoS and chvI have pleiotropic growth defects and were unable to grow on several carbon sources [ 17].	carbon,249,255,Chemical	"[{""token"": ""carbon"", ""start_span"": 249, ""end_span"": 255, ""type"": ""Chemical""}]"	train
In addition, the transcription of the S. meliloti lpsS gene, that encodes a sulfotransferase that modifies LPS, is dependent on the exoR gene [ 32].	LPS,107,110,Chemical	"[{""token"": ""LPS"", ""start_span"": 107, ""end_span"": 110, ""type"": ""Chemical""}]"	train
The fact that the expression of VjbR, OmpR and ExoR was altered in the bvrR mutant demonstrated for the first time an interaction or cross - talk among these global regulators, all involved in the control of composition and structure of the cell envelope ( OMPs, LPS, chaperones, flagella, em).	LPS,263,266,Chemical	"[{""token"": ""LPS"", ""start_span"": 263, ""end_span"": 266, ""type"": ""Chemical""}]"	train
The expression of genes vjbR, malF, norC, pckA, fumB, BAB1 _ 0017 ( fatty acids metabolism) and BAB1 _ 1620 ( LPS glycosyl transferase) were induced intracellularly.	LPS,110,113,Chemical	"[{""token"": ""LPS"", ""start_span"": 110, ""end_span"": 113, ""type"": ""Chemical""}]"	train
For examples, both S. equi and group A Streptococcus ( GAS) produce the hyaluronic acid capsule and surface protein M protein to contribute to resistance to phagocytosis by PMNs.	hyaluronic acid,72,87,Chemical	"[{""token"": ""hyaluronic acid"", ""start_span"": 72, ""end_span"": 87, ""type"": ""Chemical""}]"	train
Wild - type Salmonella grown at pH 5. 8 were > 100 000 - fold more resistant to polymyxin B than organisms grown at pH 7. 7.	polymyxin B,80,91,Chemical	"[{""token"": ""polymyxin B"", ""start_span"": 80, ""end_span"": 91, ""type"": ""Chemical""}]"	valid
Our results suggest that protonation of the PmrB periplasmic histidine and / or of the glutamic acid residues activate the PmrA protein, and that mild acid promotes cellular changes resulting in polymyxin B resistance.	polymyxin B,195,206,Chemical	"[{""token"": ""polymyxin B"", ""start_span"": 195, ""end_span"": 206, ""type"": ""Chemical""}]"	valid
The transcriptional activation of PmrA - regulated genes taking place at pH 5. 8 could be due to trace amounts of metals such as Fe3 +, which is more soluble at acidic pH.	Fe3 +,129,134,Chemical	"[{""token"": ""Fe3 +"", ""start_span"": 129, ""end_span"": 134, ""type"": ""Chemical""}]"	valid
To rule out this possibility, we treated the culture medium with Chelex 100 resin, an agent known to chelate polyvalent metal ions that does not affect Salmonella growth.	Chelex 100,65,75,Chemical	"[{""token"": ""Chelex 100"", ""start_span"": 65, ""end_span"": 75, ""type"": ""Chemical""}]"	valid
Consistent with this notion, pbgP transcription was abrogated in the pmrB mutant upon deletion of the pta and ackA genes ( Fig. 3), which encode the two enzymes that are required for the production of acetyl phosphate ( Wolfe, 2005) ( Fig. 1).	acetyl phosphate,201,217,Chemical	"[{""token"": ""acetyl phosphate"", ""start_span"": 201, ""end_span"": 217, ""type"": ""Chemical""}]"	valid
In contrast, a strain lacking the ability to synthesize acetyl phosphate but with a functional pmrB gene exhibited wild - type pbgP expression levels ( Fig. 3), implying that under normal conditions ( i. e. when a functional pmrB gene is present) acetyl phosphate does not contribute to PmrA phosphorylation.	acetyl phosphate,56,72,Chemical	"[{""token"": ""acetyl phosphate"", ""start_span"": 56, ""end_span"": 72, ""type"": ""Chemical""}]"	valid
These results imply that the pmrD gene was being expressed even though the media contained 10 mM MgCl2, a concentration known to repress transcription of PhoP - activated genes ( Soncini et al., 1996).	MgCl2,97,102,Chemical	"[{""token"": ""MgCl2"", ""start_span"": 97, ""end_span"": 102, ""type"": ""Chemical""}]"	valid
In agreement with the gene transcription data, Western blot analysis of crude extracts using anti - PmrD antibodies showed that the PmrD protein was produced in cells grown in N - minimal medium pH 5. 8 and 10 mM MgCl2 but not in cells grown in the same medium buffered at pH 7. 7 ( Fig. 4B).	MgCl2,213,218,Chemical	"[{""token"": ""MgCl2"", ""start_span"": 213, ""end_span"": 218, ""type"": ""Chemical""}]"	valid
In fact, PmrB is required for the activation of PmrA - regulated genes in response to the low Mg2 + signal, which is sensed by the PhoQ protein ( Kato and Groisman, 2004) ( Fig. 1).	Mg2 +,94,99,Chemical	"[{""token"": ""Mg2 +"", ""start_span"": 94, ""end_span"": 99, ""type"": ""Chemical""}]"	valid
Strains expressing the mutant PmrB proteins could express pbgP normally in response to the low Mg2 + signal ( Fig. 6C) ( Wosten et al., 2000), indicating that mutations in residues of the periplasmic domain of PmrB do not impair the enzymatic activity of the cytoplasmic domain of the PmrB protein.	Mg2 +,95,100,Chemical	"[{""token"": ""Mg2 +"", ""start_span"": 95, ""end_span"": 100, ""type"": ""Chemical""}]"	valid
Mild acid pH induces resistance to the antimicrobial peptide polymyxin B	polymyxin B,61,72,Chemical	"[{""token"": ""polymyxin B"", ""start_span"": 61, ""end_span"": 72, ""type"": ""Chemical""}]"	valid
Because the PmrA / PmrB system is required for resistance to the antimicrobial peptide polymyxin B ( Roland et al., 1993), we hypothesized that mild acid pH could induce this resistance.	polymyxin B,87,98,Chemical	"[{""token"": ""polymyxin B"", ""start_span"": 87, ""end_span"": 98, ""type"": ""Chemical""}]"	valid
In fact, the survival of wild - type cells to a challenge with polymyxin B was 100 000 - fold higher when they were grown at pH 5. 8 than when grown at pH 7. 7 ( Fig. 7).	polymyxin B,63,74,Chemical	"[{""token"": ""polymyxin B"", ""start_span"": 63, ""end_span"": 74, ""type"": ""Chemical""}]"	valid
This resistance was PmrA - dependent because a strain deficient in the pmrA gene was approximately 100 000 - fold more sensitive to polymyxin B than the wild - type strain when grown pH 5. 8 ( Fig. 7).	polymyxin B,132,143,Chemical	"[{""token"": ""polymyxin B"", ""start_span"": 132, ""end_span"": 143, ""type"": ""Chemical""}]"	valid
Likewise, the human receptor OGR1 responds to both pH and sphingosylphosphorylcholine ( Ludwig et al., 2003).	sphingosylphosphorylcholine,58,85,Chemical	"[{""token"": ""sphingosylphosphorylcholine"", ""start_span"": 58, ""end_span"": 85, ""type"": ""Chemical""}]"	valid
The fact that the PmrB H35A and the E64A mutant proteins displayed partial activity in response to ferric iron but were severely impaired in their ability to respond to acid pH ( compare Fig. 6B and D) supports the notion that these signals are sensed independently.	ferric iron,99,110,Chemical	"[{""token"": ""ferric iron"", ""start_span"": 99, ""end_span"": 110, ""type"": ""Chemical""}]"	valid
Because several PmrA - activated gene products are responsible for remodelling the LPS structure and these modifications are required for resistance to certain antimicrobial peptides and toxic metals, one possibility is that acidic environments provide a means to induce the cell envelope changes resulting in resistance.	LPS,83,86,Chemical	"[{""token"": ""LPS"", ""start_span"": 83, ""end_span"": 86, ""type"": ""Chemical""}]"	valid
Indeed, when grown at pH 5. 8 wild - type Salmonella were 100 000 - fold more resistant to polymyxin B than when grown at pH 7. 7 ( Fig. 7).	polymyxin B,91,102,Chemical	"[{""token"": ""polymyxin B"", ""start_span"": 91, ""end_span"": 102, ""type"": ""Chemical""}]"	valid
Finally, while a role for the PmrA - dependent LPS modifications in the previously described acid tolerance response is unlikely because survival to acid stress ( pH approximately3) was not reduced in cells deficient in pmrA ( data not shown and Bearson et al., 1998), some of the PmrA - regulated genes to which no function has been ascribed yet could mediate other cellular responses to acid pH.	LPS,47,50,Chemical	"[{""token"": ""LPS"", ""start_span"": 47, ""end_span"": 50, ""type"": ""Chemical""}]"	valid
The phosphoenolpyruvate: sugar phosphotransferase system ( PTS) is the major sugar transport system in many Gram - positive and Gram - negative bacterial species.	phosphoenolpyruvate,4,23,Chemical	"[{""token"": ""phosphoenolpyruvate"", ""start_span"": 4, ""end_span"": 23, ""type"": ""Chemical""}]"	valid
The Mlc - His6 protein was produced in E. coli and purified to > 90% homogeneity by Ni2 + affinity chromatography.	Ni2 +,84,89,Chemical	"[{""token"": ""Ni2 +"", ""start_span"": 84, ""end_span"": 89, ""type"": ""Chemical""}]"	valid
SL1344 and SR1304 carrying either pMAB69 ( hilE - lacZY) or pJB5 ( hilD - lacZY) were cultivated in TB that was buffered to pH 7. 0 with 0. 1M MOPS, to minimize pH effects arising from growth in the presence of the various carbon sources.	MOPS,143,147,Chemical	"[{""token"": ""MOPS"", ""start_span"": 143, ""end_span"": 147, ""type"": ""Chemical""}]"	valid
The expression levels of hilE and hilD remained almost unaffected in the presence of glycerol.	glycerol,85,93,Chemical	"[{""token"": ""glycerol"", ""start_span"": 85, ""end_span"": 93, ""type"": ""Chemical""}]"	valid
It has been suggested that glucose plays a negative role in the expression of invasion - associated genes in Salmonella.	glucose,27,34,Chemical	"[{""token"": ""glucose"", ""start_span"": 27, ""end_span"": 34, ""type"": ""Chemical""}]"	valid
The addition of excess glucose to the culture medium results in the reduction of cell association by S.	glucose,23,30,Chemical	"[{""token"": ""glucose"", ""start_span"": 23, ""end_span"": 30, ""type"": ""Chemical""}]"	valid
The results presented in this study support the notion that hilE expression is activated as a result of Mlc sequestration by unphosphorylated EIICBGlc in the presence of glucose.	glucose,170,177,Chemical	"[{""token"": ""glucose"", ""start_span"": 170, ""end_span"": 177, ""type"": ""Chemical""}]"	valid
All of the carbohydrates tested in this study, with the exception of glycerol, increased hilD expression by approximately1. 1 - 1. 2 - fold, even though hilE expression in the mlc mutant was increased by approximately30% in the presence of the sugars tested ( Figure 6).	glycerol,69,77,Chemical	"[{""token"": ""glycerol"", ""start_span"": 69, ""end_span"": 77, ""type"": ""Chemical""}]"	valid
The PhoR sensor kinase phosphorylates PhoB when extracellular Pi levels are low, and the phosphorylated PhoB then binds and activates the promoters in the Pho regulon.	Pi,62,64,Chemical	"[{""token"": ""Pi"", ""start_span"": 62, ""end_span"": 64, ""type"": ""Chemical""}]"	valid
( 48) have reported that the expression of sirA, which is a response regulator for BarA ( 49), is decreased in the presence of 50mM glucose.	glucose,132,139,Chemical	"[{""token"": ""glucose"", ""start_span"": 132, ""end_span"": 139, ""type"": ""Chemical""}]"	valid
The repressive effect of glucose was also observed for the downstream members of the SirA regulon, such as csrB, csrC and hilA ( 48, 49).	glucose,25,32,Chemical	"[{""token"": ""glucose"", ""start_span"": 25, ""end_span"": 32, ""type"": ""Chemical""}]"	valid
Collectively, these results show that SPI1 is not activated when Salmonella is grown in the presence of glucose ( Figure 6; 44, 45, 48).	glucose,104,111,Chemical	"[{""token"": ""glucose"", ""start_span"": 104, ""end_span"": 111, ""type"": ""Chemical""}]"	valid
We propose that Salmonella can use the glucose concentration of the mammalian intestinal tract as one of many signals for the regulation of invasion genes.	glucose,39,46,Chemical	"[{""token"": ""glucose"", ""start_span"": 39, ""end_span"": 46, ""type"": ""Chemical""}]"	valid
Simple sugars, such as glucose, are rarely encountered in the distal ileum, as most are absorbed in the proximal portion of the small intestine ( 54).	glucose,23,30,Chemical	"[{""token"": ""glucose"", ""start_span"": 23, ""end_span"": 30, ""type"": ""Chemical""}]"	valid
Positive transformants were first screened on THB agar plates under the selective pressure of spectinomycin.	spectinomycin,94,107,Chemical	"[{""token"": ""spectinomycin"", ""start_span"": 94, ""end_span"": 107, ""type"": ""Chemical""}]"	valid
First, the ability of the mutant strain to retain spectinomycin resistance was assessed.	spectinomycin,50,63,Chemical	"[{""token"": ""spectinomycin"", ""start_span"": 50, ""end_span"": 63, ""type"": ""Chemical""}]"	valid
The spectinomycin resistance phenotype was stable in DeltasalKR during in vitro culture ( data not shown).	spectinomycin,4,17,Chemical	"[{""token"": ""spectinomycin"", ""start_span"": 4, ""end_span"": 17, ""type"": ""Chemical""}]"	valid
Furthermore, orotidine - 5 - phosphate decarboxylase ( 05SSU1009), a newly identified pathogenesis - related protein in Vibrio vulnificus [ 31], was also found to be repressed greatly in DeltasalKR.	orotidine - 5 - phosphate,13,38,Chemical	"[{""token"": ""orotidine - 5 - phosphate"", ""start_span"": 13, ""end_span"": 38, ""type"": ""Chemical""}]"	valid
Suilysin, a known virulence factor, was believed to be introduced into SS2 via lateral gene transfer [ 43].	Suilysin,0,8,Chemical	"[{""token"": ""Suilysin"", ""start_span"": 0, ""end_span"": 8, ""type"": ""Chemical""}]"	valid
One mutant had an insertion in a cheB gene homologue, encoding a methylesterase involved in chemotaxis ( CheB2).	methylesterase,65,79,Chemical	"[{""token"": ""methylesterase"", ""start_span"": 65, ""end_span"": 79, ""type"": ""Chemical""}]"	valid
Finally, C. elegans death, called red death, is observed in response to PAO1 grown on phosphate - depleted medium in conjunction with physiological stress on the nematodes [ 10].	phosphate,86,95,Chemical	"[{""token"": ""phosphate"", ""start_span"": 86, ""end_span"": 95, ""type"": ""Chemical""}]"	valid
It has a high resistance to detergents [ 16] and reactive oxygen intermediates [ 17] and is able to grow within polymorphonuclear leukocytes [ 18].	oxygen,58,64,Chemical	"[{""token"": ""oxygen"", ""start_span"": 58, ""end_span"": 64, ""type"": ""Chemical""}]"	valid
Firstly, epithelia, such as alimentary tract and tracheae, are the first line of defense against pathogens and produce both antimicrobial peptides ( AMPs) and reactive oxygen species.	reactive oxygen species,159,182,Chemical	"[{""token"": ""reactive oxygen species"", ""start_span"": 159, ""end_span"": 182, ""type"": ""Chemical""}]"	test
We present in vivo evidence for a direct role in pathogenesis of the secreted P. entomophila zinc metalloprotease, AprA, which counteracts AMPs synthesized by the host.	zinc,93,97,Chemical	"[{""token"": ""zinc"", ""start_span"": 93, ""end_span"": 97, ""type"": ""Chemical""}]"	test
All of these proteases are members of the zinc metzincin family of Type I - secreted RTX proteins [ 15].	zinc,42,46,Chemical	"[{""token"": ""zinc"", ""start_span"": 42, ""end_span"": 46, ""type"": ""Chemical""}]"	test
We inactivated the aprA gene by inserting a tetracycline resistance cassette by a double homologous recombination event.	tetracycline,44,56,Chemical	"[{""token"": ""tetracycline"", ""start_span"": 44, ""end_span"": 56, ""type"": ""Chemical""}]"	test
This allows us to place the novel genes within the context of signaling and regulatory networks, including the Rcs phosphorelay pathway and the cyclic di - GMP second - messenger system.	cyclic di - GMP,144,159,Chemical	"[{""token"": ""cyclic di - GMP"", ""start_span"": 144, ""end_span"": 159, ""type"": ""Chemical""}]"	test
The protein encoded by aer mediates oxygen and redox sensing, and as such shares overlapping function with the Tsr receptor [ 22].	oxygen,36,42,Chemical	"[{""token"": ""oxygen"", ""start_span"": 36, ""end_span"": 42, ""type"": ""Chemical""}]"	test
Finally, the product of trg is a transmembrane methyl - accepting chemotaxis protein that senses ribose and galactose [ 23].	galactose,108,117,Chemical	"[{""token"": ""galactose"", ""start_span"": 108, ""end_span"": 117, ""type"": ""Chemical""}]"	test
Although this observation contradicts earlier studies on swarming in E. coli and S. enterica [ 29], more recent work has shown that chemotaxis mutants are capable of surface motility when the surface of the agar is sprayed with a fine mist of water [ 30], or when the agar concentration of the swarming media is reduced from 0. 6% to 0. 45% [ 31].	water,243,248,Chemical	"[{""token"": ""water"", ""start_span"": 243, ""end_span"": 248, ""type"": ""Chemical""}]"	test
The Rcs pathway consists of a phosphotransfer protein ( RcsD) that mediates phosphate transfer from a sensor kinase ( RcsC) to a response regulator ( RcsB) that binds DNA with an accessory protein ( RcsA).	phosphate,76,85,Chemical	"[{""token"": ""phosphate"", ""start_span"": 76, ""end_span"": 85, ""type"": ""Chemical""}]"	test
This observation is consistent with the dual functional role of RcsC as both kinase and phosphatase, moving phosphates both to and away from RcsB via RcsD, and that RcsB remains phosphorylated in rcsC null mutants [ 38, 39].	phosphates,108,118,Chemical	"[{""token"": ""phosphates"", ""start_span"": 108, ""end_span"": 118, ""type"": ""Chemical""}]"	test
The Role of the C - di - GMP Second - Messenger System in Swimming and Swarming Motility	C - di - GMP,16,28,Chemical	"[{""token"": ""C - di - GMP"", ""start_span"": 16, ""end_span"": 28, ""type"": ""Chemical""}]"	test
Based on sequence homology, YhjH, YfgF, and YegE belong to the newly identified and highly prevalent family of proteins that function in the turnover of bis - ( 3 ' - 5 ') - cyclic dimeric guanosine monophosphate ( c - di - GMP), which is a second messenger involved in the regulation of a wide variety of bacterial behaviors [ 49].	c - di - GMP,215,227,Chemical	"[{""token"": ""c - di - GMP"", ""start_span"": 215, ""end_span"": 227, ""type"": ""Chemical""}]"	test
Synthesis of c - di - GMP is catalyzed by diguanylate cyclases ( DGC) and its degradation is regulated by phosphodiesterases ( PDE).	c - di - GMP,13,25,Chemical	"[{""token"": ""c - di - GMP"", ""start_span"": 13, ""end_span"": 25, ""type"": ""Chemical""}]"	test
YhjH contains an EAL domain, and expression of this protein leads to the degradation of c - di - GMP and enhanced motility in S. enterica [ 52].	c - di - GMP,88,100,Chemical	"[{""token"": ""c - di - GMP"", ""start_span"": 88, ""end_span"": 100, ""type"": ""Chemical""}]"	test
Based on the known antagonistic effects of c - di - GMP on motility [ 52] and by following several lines of reasoning, we hypothesized the dominant enzymatic activities of the GGDEF and EAL domains in YfgF and YegE.	c - di - GMP,43,55,Chemical	"[{""token"": ""c - di - GMP"", ""start_span"": 43, ""end_span"": 55, ""type"": ""Chemical""}]"	test
Based on these observations, we propose that deleting yegE and over - expressing yfgF suppress the motility defect of the DeltayhjH strain by reducing the intracellular levels of c - di - GMP ( Figure 7).	c - di - GMP,179,191,Chemical	"[{""token"": ""c - di - GMP"", ""start_span"": 179, ""end_span"": 191, ""type"": ""Chemical""}]"	test
If c - di - GMP levels act globally and can influence motility, then insertions in many of the genes containing active GGDEF domains should rescue motility in the DeltayhjH double mutant library.	c - di - GMP,3,15,Chemical	"[{""token"": ""c - di - GMP"", ""start_span"": 3, ""end_span"": 15, ""type"": ""Chemical""}]"	test
Alternatively, specificity in c - di - GMP signaling may be due to a number of mechanisms including spatial and temporal sequestration, microcompartmentalization, restricted production / degradation, or target modification [ 56].	c - di - GMP,30,42,Chemical	"[{""token"": ""c - di - GMP"", ""start_span"": 30, ""end_span"": 42, ""type"": ""Chemical""}]"	test
The manner in which c - di - GMP alters motility at the molecular level is currently unknown.	c - di - GMP,20,32,Chemical	"[{""token"": ""c - di - GMP"", ""start_span"": 20, ""end_span"": 32, ""type"": ""Chemical""}]"	test
However, it has been reported that c - di - GMP binds to the PilZ domain of the aforementioned YcgR protein [ 48].	c - di - GMP,35,47,Chemical	"[{""token"": ""c - di - GMP"", ""start_span"": 35, ""end_span"": 47, ""type"": ""Chemical""}]"	test
In addition to its effects on swimming, we found evidence that c - di - GMP signaling also plays a role in swarming motility.	c - di - GMP,63,75,Chemical	"[{""token"": ""c - di - GMP"", ""start_span"": 63, ""end_span"": 75, ""type"": ""Chemical""}]"	test
Mutations in ycgR were also found to suppress the swarming defect of the DeltayfiR strain ( unpublished data), suggesting that YcgR binds c - di - GMP to affect both swimming and swarming motility.	c - di - GMP,138,150,Chemical	"[{""token"": ""c - di - GMP"", ""start_span"": 138, ""end_span"": 150, ""type"": ""Chemical""}]"	test
The observations that the DeltayhjH mutant is impaired in swimming but indistinguishable from the wild - type strain in swarming, while in contrast the DeltayfiR strain cannot swarm and is only mildly impaired in swimming, support the notion that c - di - GMP signaling pathways are temporally and / or spatially separated, as recently suggested by others [ 58, 59].	c - di - GMP,247,259,Chemical	"[{""token"": ""c - di - GMP"", ""start_span"": 247, ""end_span"": 259, ""type"": ""Chemical""}]"	test
ZnuA and ZnuC are part of a high - affinity zinc uptake system.	zinc,44,48,Chemical	"[{""token"": ""zinc"", ""start_span"": 44, ""end_span"": 48, ""type"": ""Chemical""}]"	test
These interactions correspond to important network - level concepts; for example, the flow of information within signal transduction pathways and second - messenger systems such as c - di - GMP.	c - di - GMP,181,193,Chemical	"[{""token"": ""c - di - GMP"", ""start_span"": 181, ""end_span"": 193, ""type"": ""Chemical""}]"	test
Moreover, the vancomycin resistance phenotype makes this strain more of a risk to handle in the laboratory.	vancomycin,14,24,Chemical	"[{""token"": ""vancomycin"", ""start_span"": 14, ""end_span"": 24, ""type"": ""Chemical""}]"	test
OG1RF is a rifampicin and fusidic acid resistant derivative of OG1 [ 8, 9].	rifampicin,11,21,Chemical	"[{""token"": ""rifampicin"", ""start_span"": 11, ""end_span"": 21, ""type"": ""Chemical""}]"	test
Interestingly, the two vancomycin resistant strains tested were both cas negative.	vancomycin,23,33,Chemical	"[{""token"": ""vancomycin"", ""start_span"": 23, ""end_span"": 33, ""type"": ""Chemical""}]"	test
Consequently, it seems unlikely that this operon is a remnant of a vancomycin resistance operon in OG1RF, but rather part of a still unknown regulatory pathway.	vancomycin,67,77,Chemical	"[{""token"": ""vancomycin"", ""start_span"": 67, ""end_span"": 77, ""type"": ""Chemical""}]"	test
In L. casei, the myo - inositol operon consists of ten genes with an upstream divergent regulator gene, iolR.	myo - inositol,17,31,Chemical	"[{""token"": ""myo - inositol"", ""start_span"": 17, ""end_span"": 31, ""type"": ""Chemical""}]"	test
To survey E. faecalis, also a member of this order, for the presence of the iol operon, 48 isolates with different MLST and / or from various origins ( including OG1RF and V583) were tested for myo - inositol fermentation; 23 of 48 isolates were positive.	myo - inositol,194,208,Chemical	"[{""token"": ""myo - inositol"", ""start_span"": 194, ""end_span"": 208, ""type"": ""Chemical""}]"	test
In addition, PCR verified the presence of iolE and iolR in these strains and in one negative for myo - inositol fermentation, indicating that the iol operon is not unique to OG1RF.	myo - inositol,97,111,Chemical	"[{""token"": ""myo - inositol"", ""start_span"": 97, ""end_span"": 111, ""type"": ""Chemical""}]"	test
To verify that the iol genes are responsible for the fermentation of myo - inositol in OG1RF, transposon insertion mutants [ 9] in the iolB and iolG2 genes of OG1RF were tested.	myo - inositol,69,83,Chemical	"[{""token"": ""myo - inositol"", ""start_span"": 69, ""end_span"": 83, ""type"": ""Chemical""}]"	test
In V583, this region encodes probable prophage proteins and carries the vanB transposon, which confers vancomycin resistance.	vancomycin,103,113,Chemical	"[{""token"": ""vancomycin"", ""start_span"": 103, ""end_span"": 113, ""type"": ""Chemical""}]"	test
The mutation leading to rifampicin resistance was identified in the rpoB gene by Ozawa et al.	rifampicin,24,34,Chemical	"[{""token"": ""rifampicin"", ""start_span"": 24, ""end_span"": 34, ""type"": ""Chemical""}]"	test
Fusidic acid resistance is associated with mutation ( s) in the fusA gene, which encodes elongation factor G.	Fusidic acid,0,12,Chemical	"[{""token"": ""Fusidic acid"", ""start_span"": 0, ""end_span"": 12, ""type"": ""Chemical""}]"	test
Those of particular interest include new surface proteins ( MSCRAMMs and WxL domain proteins), an operon encoding myo - inositol utilization, an intact competence operon, and two CRISPR elements.	myo - inositol,114,128,Chemical	"[{""token"": ""myo - inositol"", ""start_span"": 114, ""end_span"": 128, ""type"": ""Chemical""}]"	test
These proteins represent a broad spectrum of Salmonella proteins required for many biological processes including host cell invasion, motility, central metabolism, LPS biosynthesis, two - component regulatory systems, and fatty acid metabolism.	LPS,164,167,Chemical	"[{""token"": ""LPS"", ""start_span"": 164, ""end_span"": 167, ""type"": ""Chemical""}]"	test
Other metabolic processes regulated by Hfq include Fatty acid metabolism ( FadA, FadB, FabA, FabZ, fbab, AccB, Acs, FabG, FabF, FabI, FabB); Arginine catabolism ( AstABCD); and Propanoite catabolism ( PrpBCDE).	Propanoite,177,187,Chemical	"[{""token"": ""Propanoite"", ""start_span"": 177, ""end_span"": 187, ""type"": ""Chemical""}]"	test
In addition to the three mentioned above Hfq negatively modulates PhoB involved in the phosphate starvation response, RstA, NarP, RcsB, BasR, and CpxR.	phosphate,87,96,Chemical	"[{""token"": ""phosphate"", ""start_span"": 87, ""end_span"": 96, ""type"": ""Chemical""}]"	test
Propanediol utilization operon	Propanediol,0,11,Chemical	"[{""token"": ""Propanediol"", ""start_span"": 0, ""end_span"": 11, ""type"": ""Chemical""}]"	test
The cob operon is required for the de novo biosynthesis of vitamin B12 in Salmonella Typhimurium.	vitamin B12,59,70,Chemical	"[{""token"": ""vitamin B12"", ""start_span"": 59, ""end_span"": 70, ""type"": ""Chemical""}]"	test
Lipopolysaccharide synthesis gene lpsE was induced in X. koppenhoeferi but not in P. temperata.	Lipopolysaccharide,0,18,Chemical	"[{""token"": ""Lipopolysaccharide"", ""start_span"": 0, ""end_span"": 18, ""type"": ""Chemical""}]"	test
Photorhabdus temperata displayed upregulation of genes encoding siderophore - dependent iron uptake system, but X. koppenhoeferi upregulated genes encoding siderophore - independent ion uptake system.	iron,88,92,Chemical	"[{""token"": ""iron"", ""start_span"": 88, ""end_span"": 92, ""type"": ""Chemical""}]"	test
Photorhabdus temperata induced genes for amino acid acquisition but X. koppenhoeferi upregulated malF gene, encoding a maltose uptake system.	maltose,119,126,Chemical	"[{""token"": ""maltose"", ""start_span"": 119, ""end_span"": 126, ""type"": ""Chemical""}]"	test
P. luminescens produces a signaling molecule AI - 2 to resist reactive oxygen species [ 8] and phenylpropanoid chemical ST to inhibit the activity of antimicrobial enzyme PO and formation of melanotic nodules [ 9], but the strategy used by X. nematophila appears to be that of suppression of transcripts involved in the insect immune response [ 10 - 12].	reactive oxygen species,62,85,Chemical	"[{""token"": ""reactive oxygen species"", ""start_span"": 62, ""end_span"": 85, ""type"": ""Chemical""}]"	test
For example, regulation of genes yncB and purH in P. temperata are influenced by aromatic compounds and formate, respectively ( see Additional file 1).	formate,104,111,Chemical	"[{""token"": ""formate"", ""start_span"": 104, ""end_span"": 111, ""type"": ""Chemical""}]"	test
As a well - defined virulence factor playing a major role in the development of septicemia [ 22], lipopolysaccharide biosynthesis gene lpsE was induced in X. koppenhoeferi, but not in P. temperata, which may explain in part why relatively slower growing X. koppenhoeferi did not differ from P. temperata in virulence to R. majalis in our previous studies [ 17].	lipopolysaccharide,98,116,Chemical	"[{""token"": ""lipopolysaccharide"", ""start_span"": 98, ""end_span"": 116, ""type"": ""Chemical""}]"	test
Responding to low Mg2 + levels, phoP expression is auto - regulated by PhoP and PhoQ proteins and phoQ is constitutive [ 25].	Mg2 +,18,23,Chemical	"[{""token"": ""Mg2 +"", ""start_span"": 18, ""end_span"": 23, ""type"": ""Chemical""}]"	test
Auto - regulation of phoP likely regulates expression of other genes that mediate various cellular functions such as LPS modification, cell structure [ 26], and type III secretion systems [ 27].	LPS,117,120,Chemical	"[{""token"": ""LPS"", ""start_span"": 117, ""end_span"": 120, ""type"": ""Chemical""}]"	test
Identification of genes encoding hemolysin related proteins in P. temperata ( fhaC) and X. koppenhoeferi ( xhlA) may suggest their role in dealing with the insect cellular immune response and iron scavenge [ 31, 32].	iron,192,196,Chemical	"[{""token"": ""iron"", ""start_span"": 192, ""end_span"": 196, ""type"": ""Chemical""}]"	test
Gene surA is important for bacterial survival during infection [ 41, 42] to avoid accumulation of non - native protein conformations [ 42 - 44], and uspB gene product is usually accumulated in the stationary phase and probably important for ethanol stress [ 45].	ethanol,241,248,Chemical	"[{""token"": ""ethanol"", ""start_span"": 241, ""end_span"": 248, ""type"": ""Chemical""}]"	test
Glutathione plays a major role in protection against oxidative stress and in detoxification of hazardous chemicals or heavy metals [ 49].	Glutathione,0,11,Chemical	"[{""token"": ""Glutathione"", ""start_span"": 0, ""end_span"": 11, ""type"": ""Chemical""}]"	test
Thus, although gshB and gor corresponding products are involved in different glutathione biosynthesis pathways, expression of these two genes may suggests possible role of detoxification mechanism in P. temperata and X. koppenhoeferi during infection of R. majalis.	glutathione,77,88,Chemical	"[{""token"": ""glutathione"", ""start_span"": 77, ""end_span"": 88, ""type"": ""Chemical""}]"	test
Three genes, aceE, aceK and dld, whose products catalyze subsequent steps of the glyoxylate pathway [ 53], were induced in X. koppenhoeferi.	glyoxylate,81,91,Chemical	"[{""token"": ""glyoxylate"", ""start_span"": 81, ""end_span"": 91, ""type"": ""Chemical""}]"	test
In contrast, two genes kdgK and pckA involved in energy metabolism in the TCA cycle were upregulated in P. temperata [ 54, 55].	TCA,74,77,Chemical	"[{""token"": ""TCA"", ""start_span"": 74, ""end_span"": 77, ""type"": ""Chemical""}]"	test
Genes related to the TCA cycle have been also found to be induced in other bacteria upon host infection, for example in P. luminescens in the presence of G. mellonella homogenate [ 16] and in Vibrio cholerae upon infection of infant mice [ 56, 57].	TCA,21,24,Chemical	"[{""token"": ""TCA"", ""start_span"": 21, ""end_span"": 24, ""type"": ""Chemical""}]"	test
Therefore, upregulation of bioB encoding a biontin synthetase protein further suggests that TCA cycle is involved in P. temperata.	TCA,92,95,Chemical	"[{""token"": ""TCA"", ""start_span"": 92, ""end_span"": 95, ""type"": ""Chemical""}]"	test
Ion scavenging systems induced in P. temperata and X. koppenhoeferi are completely different.	Ion,0,3,Chemical	"[{""token"": ""Ion"", ""start_span"": 0, ""end_span"": 3, ""type"": ""Chemical""}]"	test
Similarly, it has been discussed previously that histidine and phosphatidylethanolamine, the possible components presented in the insect host hemolymph, may be important food sources used by P. luminescens for growth within the insect host [ 64].	phosphatidylethanolamine,63,87,Chemical	"[{""token"": ""phosphatidylethanolamine"", ""start_span"": 63, ""end_span"": 87, ""type"": ""Chemical""}]"	test
Photorhabdus and Xenorhabdus bacteria appear to share more genes in host - induced stress protection category, including tolerance against universal stresses, glutathione - mediated protection against oxidative stress, and protection against nucleic acid damage, compared to genes in all other categories.	glutathione,159,170,Chemical	"[{""token"": ""glutathione"", ""start_span"": 159, ""end_span"": 170, ""type"": ""Chemical""}]"	test
Both experiments showed that iron acquisition was highly important for the virulence of A. pleuropneumoniae, with the identification of mutants impaired for the ExbB - ExbD - TonB energy - transducing system.	iron,29,33,Chemical	"[{""token"": ""iron"", ""start_span"": 29, ""end_span"": 33, ""type"": ""Chemical""}]"	test
Additionally, Agarwal et al. used a custom - made Fur and iron regulon microarray to investigate the expression of these genes during gonococcal infection in women [ 24].	iron,58,62,Chemical	"[{""token"": ""iron"", ""start_span"": 58, ""end_span"": 62, ""type"": ""Chemical""}]"	test
The Fur transcriptional regulator, which represses transcription of genes associated with iron acquisition [ 40], showed a 2. 6 fold down - regulation in transcription.	iron,90,94,Chemical	"[{""token"": ""iron"", ""start_span"": 90, ""end_span"": 94, ""type"": ""Chemical""}]"	test
Iron restriction if often thought to be an important signal for bacteria, and has often been linked with the expression of virulence factors such as toxins [ 42].	Iron,0,4,Chemical	"[{""token"": ""Iron"", ""start_span"": 0, ""end_span"": 4, ""type"": ""Chemical""}]"	test
Therefore, it would seem that the in vivo environment towards the end of the acute phase of pleuropneumonia is not iron - restricted for A. pleuropneumoniae.	iron,45,49,Chemical	"[{""token"": ""iron"", ""start_span"": 45, ""end_span"": 49, ""type"": ""Chemical""}]"	test
However, a few genes involved in iron acquisition, namely APL _ 0096, APL _ 0668, hbpA and irp, were up - regulated.	iron,33,37,Chemical	"[{""token"": ""iron"", ""start_span"": 33, ""end_span"": 37, ""type"": ""Chemical""}]"	test
Since these genes were not identified in a previous transcript profiling experiment under iron - restricted conditions [ 28], this might imply that they are not regulated by Fur.	iron,90,94,Chemical	"[{""token"": ""iron"", ""start_span"": 90, ""end_span"": 94, ""type"": ""Chemical""}]"	test
Studies in our laboratory have shown that it is the core oligosaccharide that is responsible for the previously observed LPS - associated adhesion mechanism [ 54, 55].	LPS,121,124,Chemical	"[{""token"": ""LPS"", ""start_span"": 121, ""end_span"": 124, ""type"": ""Chemical""}]"	test
Genes from the maltose operon, involved in the uptake and catabolism of maltose [ 56], were up - regulated: the genes malP, malK, malF, malG, malQ and a malM homolog ( APL _ 1234) were actively transcribed in the host ( average fold increase of 3. 1), and gene lamB1, which codes for a maltoporin, showed a 5. 14 fold change in the only hybridization in which the reporter wasn ' t manually flagged because of signal saturation.	maltose,15,22,Chemical	"[{""token"": ""maltose"", ""start_span"": 15, ""end_span"": 22, ""type"": ""Chemical""}]"	test
While it was first identified for its hemagglutination properties [ 72], FHA can bind carbohydrates, heparan sulphate and integrin [ 73].	heparan sulphate,101,117,Chemical	"[{""token"": ""heparan sulphate"", ""start_span"": 101, ""end_span"": 117, ""type"": ""Chemical""}]"	test
CovR regulatory activity is thought to be triggered when the protein is phosphorylated at D53 [ 21], possibly by acetyl phosphate [ 22], [ 23].	acetyl phosphate,113,129,Chemical	"[{""token"": ""acetyl phosphate"", ""start_span"": 113, ""end_span"": 129, ""type"": ""Chemical""}]"	test
The difference in buoyancy can also be attributed to differences in the expression of hyaluronic acid capsule ( AP > WT).	hyaluronic acid,86,101,Chemical	"[{""token"": ""hyaluronic acid"", ""start_span"": 86, ""end_span"": 101, ""type"": ""Chemical""}]"	test
Many of these genes encode metabolic enzymes ( e. g., carbohydrate metabolism, arginine degradation, and pyrimidine biosynthesis), ribosomal proteins ( mostly downregulated), and sugar or peptide transport systems, reflecting the transition from a carbohydrate - rich laboratory medium to a protein - rich, oxygen - poor subcutaneous tissue.	oxygen,307,313,Chemical	"[{""token"": ""oxygen"", ""start_span"": 307, ""end_span"": 313, ""type"": ""Chemical""}]"	test
Examples of neighbor clusters ( NCs) enriched in differentially expressed genes are a locus involved in L - ascorbate utilization ( SPy0175 - SPy0179); the citrate lyase locus ( SPy1186 - SPy1191); the Trx chromosomal locus ( SPy1582 - SPy1596) that includes the recently described, CovR - repressed two - component response regulator TrxR [ 42]; and the well - studied Mga ( SPy2010 - SPy2025), SpeB ( SPy2037 - SPy2042), and capsule synthesis ( SPy2200 - SPy2202) loci ( Fig. 3 and Fig. S4).	L - ascorbate,104,117,Chemical	"[{""token"": ""L - ascorbate"", ""start_span"": 104, ""end_span"": 117, ""type"": ""Chemical""}]"	test
Upregulated gene sets in AP vs. WT bacteria in vitro included Mga locus genes ( e. g., sic, emm, scp); hyaluronic acid capsule - encoding genes ( hasABC); and genes encoding the toxins SpeA, SclA, SLO, and the streptodornase Sda1 ( Fig. 2, Fig. S2, and Table 3).	hyaluronic acid,103,118,Chemical	"[{""token"": ""hyaluronic acid"", ""start_span"": 103, ""end_span"": 118, ""type"": ""Chemical""}]"	test
For example, several gene sets ( e. g., SLS genes, Trx - locus genes, L - ascorbate utilization genes) were upregulated in WT bacteria in vivo, but were mostly silenced in AP bacteria in vivo ( Fig. 2, CC6).	L - ascorbate,70,83,Chemical	"[{""token"": ""L - ascorbate"", ""start_span"": 70, ""end_span"": 83, ""type"": ""Chemical""}]"	test
DltR / DltS of S. agalactiae is important for transcription of dlt operon ( dltA, dltB, dltC, and dltD genes), which is necessary for incorporation of D - alanine residues in lipoteichoic acids.	lipoteichoic acids,175,193,Chemical	"[{""token"": ""lipoteichoic acids"", ""start_span"": 175, ""end_span"": 193, ""type"": ""Chemical""}]"	test
In S. pneumoniae genome, the hk06 and rr06 genes are adjacent to cbpA gene encoding choline binding protein, CbpA, a surface - exposed protective antigen and virulence factor of S. pneumoniae [ 20], [ 21].	choline,84,91,Chemical	"[{""token"": ""choline"", ""start_span"": 84, ""end_span"": 91, ""type"": ""Chemical""}]"	test
An occurrence of bac gene, sak188, sak189 TCS genes and erythromycin resistance among S. agalactiae strains A total of 239 S. agalactiae strains isolated from human and animals were studied.	erythromycin,56,68,Chemical	"[{""token"": ""erythromycin"", ""start_span"": 56, ""end_span"": 68, ""type"": ""Chemical""}]"	test
Thus, the strains were additionally screened for sensitivity to Em.	Em,64,66,Chemical	"[{""token"": ""Em"", ""start_span"": 64, ""end_span"": 66, ""type"": ""Chemical""}]"	test
The recombinant clones were selected on THB agar plates containing 2. 5 microg / ml of erythromycin.	erythromycin,87,99,Chemical	"[{""token"": ""erythromycin"", ""start_span"": 87, ""end_span"": 99, ""type"": ""Chemical""}]"	test
As result, 10 min boiling of the cells in 2 - mercaptoethanol ( 10%, w / w) was found to be most effective with respect to higher yield and quality of the protein bands observed after SDS - PAGE ( data not shown).	2 - mercaptoethanol,42,61,Chemical	"[{""token"": ""2 - mercaptoethanol"", ""start_span"": 42, ""end_span"": 61, ""type"": ""Chemical""}]"	test
