Sentence	entity_1	json	split
The median age of participants was 32. 5 ( IQR 2636), and all were homozygous for the F508del mutation except for one who was a compound heterozygote, F508del / 621 + 1G - T ( Table 1).	homozygous for the F508del mutation,67,102,state	"[{""token"": ""homozygous for the F508del mutation"", ""start_span"": 67, ""end_span"": 102, ""type"": ""state""}]"	test
The sponge carriers were soaked with the master slurry sample manually and placed into the glass column in a cold room maintained at 4C.	4C,133,135,state	"[{""token"": ""4C"", ""start_span"": 133, ""end_span"": 135, ""type"": ""state""}]"	test
Biogas production was monitored by a gas flow measurement device ( flow, Bioprocess Control, Lund, Sweden) and recorded daily.	Biogas,0,6,state	"[{""token"": ""Biogas"", ""start_span"": 0, ""end_span"": 6, ""type"": ""state""}]"	test
Determination of Alkylbenzene Utilization in hNRB Enrichments To the first set of microcosms a known volume of mesitylene ( 1, 3, 5 - trimethylbenzene) was added to the oil layer at the end of incubation period.	Alkylbenzene Utilization,17,41,state	"[{""token"": ""Alkylbenzene Utilization"", ""start_span"": 17, ""end_span"": 41, ""type"": ""state""}]"	test
The anions elements such as SO42 were measured with an Ion Chromatography ( ICS - 1000, Dionex, Sunnyvale, CA, USA).	SO42,28,32,state	"[{""token"": ""SO42"", ""start_span"": 28, ""end_span"": 32, ""type"": ""state""}]"	test
The concentration of total dissolved phosphorus was determined spectrophotometrically using the molybdate method after digestion with sulfuric acid and hydrogen peroxide.	total dissolved phosphorus,21,47,state	"[{""token"": ""total dissolved phosphorus"", ""start_span"": 21, ""end_span"": 47, ""type"": ""state""}]"	test
For intraperitoneal infection, mice were injected with ~ 20 L via insulin syringe ( 29 G needle) with undiluted virus into the peritoneal cavity.	intraperitoneal infection,4,29,state	"[{""token"": ""intraperitoneal infection"", ""start_span"": 4, ""end_span"": 29, ""type"": ""state""}]"	test
Following the inoculation of the reactors, seed sludge was acclimatised to the reactor environment at 30C with 1. 8g volatile solids ( VS) L1day1 organic loading rate ( OLR) and a hydraulic retention time ( HRT) of 20days for 190days.	30C,102,105,state	"[{""token"": ""30C"", ""start_span"": 102, ""end_span"": 105, ""type"": ""state""}]"	test
The biological methane potential ( BMP: mL CH4mL enzyme mixture1) of the enzyme mixture was measured as described previously ( Azman et al. 2015b).	methane,15,22,state	"[{""token"": ""methane"", ""start_span"": 15, ""end_span"": 22, ""type"": ""state""}]"	test
The inflammatory cells may extend into submucosa, smooth muscle and serosal layer.	inflammatory cells,4,22,state	"[{""token"": ""inflammatory cells"", ""start_span"": 4, ""end_span"": 22, ""type"": ""state""}]"	test
Furthermore, at this experimental stage, batch systems were utilized to avoid potential heterogeneity of granular sludge resulting from plug - flow hydraulic regimes associated with the operation of sludge bed up - flow reactors ( Wu and Hickey, 1997).	plug - flow hydraulic,136,157,state	"[{""token"": ""plug - flow hydraulic"", ""start_span"": 136, ""end_span"": 157, ""type"": ""state""}]"	test
Additional liquid samples ( 4mL) for metagenomic analyses were collected in three replicates and in three time points ( days 41, 52, and 61) at steady - state condition from R1 and R3.	steady - state,144,158,state	"[{""token"": ""steady - state"", ""start_span"": 144, ""end_span"": 158, ""type"": ""state""}]"	test
Following a centrifugation step ( 30, 000 gav), supernatants were acidified with 6 M HCl ( pH < 2) and extracted and analyzed for putative hydrocarbon metabolites as silylated compounds by gas chromatography - mass spectrometry ( GC - MS) following the procedure outlined by Berdugo - Clavijo and Gieg ( 2014).	hydrocarbon metabolites,139,162,state	"[{""token"": ""hydrocarbon metabolites"", ""start_span"": 139, ""end_span"": 162, ""type"": ""state""}]"	test
This is especially relevant in the context of climate change, considering the Western Antarctic Peninsula ( WAP) is one of the areas that is experiencing one of the fastest rates of warming on Earth ( Cook et al., 2016; Meredith & King, 2005).	fastest rates of warming,165,189,state	"[{""token"": ""fastest rates of warming"", ""start_span"": 165, ""end_span"": 189, ""type"": ""state""}]"	test
Finally, differentially abundant AR genes between subjects that acquired MDRO or not were investigated using LEfSe with default parameters ( Segata et al., 2011).	acquired MDRO,64,77,state	"[{""token"": ""acquired MDRO"", ""start_span"": 64, ""end_span"": 77, ""type"": ""state""}]"	test
Italian adults, living in and around Bologna, recruited as a Western cohort in Schnorr et al. 2, were recalled to provide fecal specimens; as many as 12 subjects ( age: 2340 years; mean, 33) provided the samples.	Italian adults,0,14,state	"[{""token"": ""Italian adults"", ""start_span"": 0, ""end_span"": 14, ""type"": ""state""}]"	test
The 2000 m sample was characterized by an almost undetectable Chl - a concentration ( 0. 01 mg / m3), lower TOC ( 0. 94 mg C / L), higher total N and p - values ( 8. 62 and 0. 5 M, respectively), and lower heterotrophic bacteria counts ( 4. 5 104) [ 55, 56].	2000 m,4,10,state	"[{""token"": ""2000 m"", ""start_span"": 4, ""end_span"": 10, ""type"": ""state""}]"	test
Four transects were defined in north - east ( S77 39. 489, E163 07. 501), south - east ( S77 39. 513, E163 07. 626), south ( S77 39. 589, E163 07. 006), and north - west ( S77 39. 470, E163 06. 336) facing hyporheic moisture gradients.	hyporheic moisture,206,224,state	"[{""token"": ""hyporheic moisture"", ""start_span"": 206, ""end_span"": 224, ""type"": ""state""}]"	test
Virome capture sequencing does not identify active viral infection in unicentric and idiopathic multicentric Castleman disease Castleman disease ( CD) describes a spectrum of heterogeneous disorders defined by characteristic lymph node histopathology.	lymph node histopathology,225,250,state	"[{""token"": ""lymph node histopathology"", ""start_span"": 225, ""end_span"": 250, ""type"": ""state""}]"	test
Most animals consumed the entire daily volume of DSSwater for the treatment duration, however, some animals failed to ingest the prescribed dose and some animals consumed each dose more rapidly than others, which may be reflected in some of the animal - to - animal variability seen in our measures of colitis.	colitis,302,309,state	"[{""token"": ""colitis"", ""start_span"": 302, ""end_span"": 309, ""type"": ""state""}]"	test
Methods Animals and Sample Collection We obtained female individuals of Peromyscus species ( P. polionotus, P. maniculatus, P. leucopus, P. eremicus, P. californicus, 5 individuals per species, except for P. maniculatus, where n = 3) from the Peromyscus Genetic Stock Center at the University of South Carolina.	female,50,56,state	"[{""token"": ""female"", ""start_span"": 50, ""end_span"": 56, ""type"": ""state""}]"	test
were between 5 and 8 months old, and were co - housed ( within species) prior to our experiment.	between 5 and 8 months old,5,31,state	"[{""token"": ""between 5 and 8 months old"", ""start_span"": 5, ""end_span"": 31, ""type"": ""state""}]"	test
Fecal samples were collected at the hospital between 24 and 48 h of life and at 10, 30, and 90 days of age, immediately frozen at 20 C and processed as described by Arboleya and co - workers [ 22].	between 24 and 48 h of life,45,72,state	"[{""token"": ""between 24 and 48 h of life"", ""start_span"": 45, ""end_span"": 72, ""type"": ""state""}]"	test
ABX - treated water was sterile filtered prior to placement in mouse cages and provided to mice ad libitum.	ABX - treated,0,13,state	"[{""token"": ""ABX - treated"", ""start_span"": 0, ""end_span"": 13, ""type"": ""state""}]"	test
Upon eclosion, 10 adults carrying either mun + or mun - strains were dissected and their guts were plated onto non - selective MRS agar ( S4 Fig).	adults,18,24,state	"[{""token"": ""adults"", ""start_span"": 18, ""end_span"": 24, ""type"": ""state""}]"	test
Medium composition Both chemostat cultures were continuously supplied with identically prepared anoxic, sterile liquid medium containing a defined mixture of glucose, aminoacids, acetate, nitrite, and nitrate.	anoxic,96,102,state	"[{""token"": ""anoxic"", ""start_span"": 96, ""end_span"": 102, ""type"": ""state""}]"	test
Thus, to ensure feasibility of recruitment for this study we limited our population to women.	women,87,92,state	"[{""token"": ""women"", ""start_span"": 87, ""end_span"": 92, ""type"": ""state""}]"	test
16S rRNA gene microbial community analysis PCR and amplicon sequencing Primers applied for the amplification of the amplification of the bacterial and archaeal 16SrRNA gene fragments are listed in Table2 and were previously tested for applicability to monitor the microbial community in biogas environments ( Fischer etal., 2016).	biogas,287,293,state	"[{""token"": ""biogas"", ""start_span"": 287, ""end_span"": 293, ""type"": ""state""}]"	test
Metaproteomics Samples used for metaproteomics experiments were collected from in situ nylon bags containing 5g of air - dried switch grass or corn stover that were placed in the rumen of two cannulated cows ( designated Y and Z).	cannulated,192,202,state	"[{""token"": ""cannulated"", ""start_span"": 192, ""end_span"": 202, ""type"": ""state""}]"	test
To search for MAME 1 like sequences in other metabarcoding studies we downloaded 487 marine pelagic environmental 18S amplicon datasets from NCBIs SRA ( March 2016) using fastq - dump from SRA - toolkit with - R option ( List of amplicons available in the online supplementary material: https: / / figshare. com / articles / Supplementary _ Data _ Lopez - Escardo _ et _ al _ 2016 / 3475007), which selects the high quality reads63.	marine,85,91,state	"[{""token"": ""marine"", ""start_span"": 85, ""end_span"": 91, ""type"": ""state""}]"	test
The CSTRs were inoculated from a lab - scale digester operated at a dilution rate of 0. 125 days - 1 with the same synthetic substrate for 7 months.	lab - scale,33,44,state	"[{""token"": ""lab - scale"", ""start_span"": 33, ""end_span"": 44, ""type"": ""state""}]"	test
A total of 12l of blood sample were used to measure blood glucose level using a blood glucose meter and a test strip ( Clarity Plus, Boca Raton, FL, USA).	blood glucose level,52,71,state	"[{""token"": ""blood glucose level"", ""start_span"": 52, ""end_span"": 71, ""type"": ""state""}]"	test
Seven individuals collected in 2016 were treated similarly, with the exception that whole, sediment - free animals were transferred to centrifuge tubes with Lifeguard.	sediment - free,91,106,state	"[{""token"": ""sediment - free"", ""start_span"": 91, ""end_span"": 106, ""type"": ""state""}]"	test
Gnotobiotic mouse experiments All experiments involving mice were performed using protocols approved by the Animal Studies Committee of the Washington University School of Medicine.	Gnotobiotic,0,11,state	"[{""token"": ""Gnotobiotic"", ""start_span"": 0, ""end_span"": 11, ""type"": ""state""}]"	test
All mothers attending the clinics during the recruitment periods at each location were invited to participate in the study and written consent was obtained from all who agreed to participate.	mothers,4,11,state	"[{""token"": ""mothers"", ""start_span"": 4, ""end_span"": 11, ""type"": ""state""}]"	test
Animal models such as adjuvant - induced arthritis ( AIA), one of the most widely accepted animal models [ 1316], may provide new knowledge on the relationship between the microbiota and RA and possibly contribute to the development of novel microbial - based drugs.	RA,187,189,state	"[{""token"": ""RA"", ""start_span"": 187, ""end_span"": 189, ""type"": ""state""}]"	test
A B C D E Sampling site Underwater depth [ m] ( Depth) 548 24 54 48 110 Bottom temperature [ C] ( Temp) 6 11 3 6 2 Bottom salinity ( Sal) 35 21 8 7 4 Oxygen bottom water [ mL / L] 6. 1 4. 8 3. 6 5. 6 7. 5 SO42 - [ mM] calculated1 28. 2 16. 9 6. 4 5. 6 3. 2 Sediment characteristics Median grain size [ Q50] 5 11 12 3377 10 Sediment type Fine silt Middle silt Middle silt Silty - sandy Middle silt Water content [%] 76 78 54 33 87 Total nitrogen [%] ( TN) 0. 3 0. 0 0. 5 0. 0 0. 3 0. 3 0. 04 0. 0 0. 4 0. 0 Total organic carbon	salinity,122,130,state	"[{""token"": ""salinity"", ""start_span"": 122, ""end_span"": 130, ""type"": ""state""}]"	test
ALOHA ( A Long - term Oligotrophic Habitat Assessment; 22. 45N, 158W), an open - ocean field site ~ 100 km north of Oahu ( Table 1).	open,74,78,state	"[{""token"": ""open"", ""start_span"": 74, ""end_span"": 78, ""type"": ""state""}]"	test
Foods and portions from 24 - hour dietary recalls were entered into the USDA SuperTracker system ( Britten, 2013).	dietary recalls,34,49,state	"[{""token"": ""dietary recalls"", ""start_span"": 34, ""end_span"": 49, ""type"": ""state""}]"	test
Definition of carriage by lytA Pcr The presence of S. pneumoniae was assessed using a lytA qPCR as described ( WHO and CDC, 2011) using primers F373: 5 - ACGCAATCTAGCAGATGAAGCA - 3 and R424: 5 TCGTGCGTTTTAATTCCAGCT - 3.	carriage,14,22,state	"[{""token"": ""carriage"", ""start_span"": 14, ""end_span"": 22, ""type"": ""state""}]"	test
All samples were de - identified, and by using information from participants assigned to a menstrual phase by using a calendar - based method: menstrual, day 1 ( onset of menstruation) to cessation of bleeding ( day 4 to 7); follicular, cessation of bleeding to day 12; periovulatory, day 13 to day 16; luteal, day 17 to days 26 to 32 ( commencement of bleeding).	menstrual phase,91,106,state	"[{""token"": ""menstrual phase"", ""start_span"": 91, ""end_span"": 106, ""type"": ""state""}]"	test
Dissolved oxygen and temperature ( Oxymeter YSI 550A), conductivity ( Digimed DM - 3P), turbidity ( Motte 202VE), and water transparency ( Secchi disk) were measured in the field.	Dissolved oxygen,0,16,state	"[{""token"": ""Dissolved oxygen"", ""start_span"": 0, ""end_span"": 16, ""type"": ""state""}]"	test
Spring samples were collected according to following criteria: evidence of continuous water flow from the rock, close to bubbling zones, and near the most reductive point.	continuous water flow from the rock,75,110,state	"[{""token"": ""continuous water flow from the rock"", ""start_span"": 75, ""end_span"": 110, ""type"": ""state""}]"	test
Duplicate filters were collected in August 2008 and 2009, 1 h before both day and night high tide on consecutive days ( 11).	1 h before both day and night high tide,58,97,state	"[{""token"": ""1 h before both day and night high tide"", ""start_span"": 58, ""end_span"": 97, ""type"": ""state""}]"	test
Taxonomic Comparison of Phylotypes in Serpentinizing Environments The correctly formatted amplicons and clone libraries of five serpentinizing ecosystems were downloaded from public databases ( SRA and Genbank).	serpentinizing,128,142,state	"[{""token"": ""serpentinizing"", ""start_span"": 128, ""end_span"": 142, ""type"": ""state""}]"	test
A single pathologist ( M. B. Piazuelo), blind to treatment groups, assessed and scored indices of inflammation and injury 6 weeks postchallenge.	inflammation,98,110,state	"[{""token"": ""inflammation"", ""start_span"": 98, ""end_span"": 110, ""type"": ""state""}]"	test
A conventional TSF maximum intensity threshold of 10, 000 is often used as an indicator of migrated petroleum in prospective basins around the world [ 41]; however, this threshold was elevated five - fold ( 50, 000 intensity units) for interpreting the TSF values obtained in this study.	migrated petroleum,91,109,state	"[{""token"": ""migrated petroleum"", ""start_span"": 91, ""end_span"": 109, ""type"": ""state""}]"	test
When the AnMBR faced hydraulic overloading due to the technical failure, one sample ( F10) was collected on day 210 ( 29 April 2016), and after twenty days later on day 230 ( 21 May 2016), a second sample ( J15) was collected to further understand this phenomenon, as a new inoculum ( Seed 2) was used on the day 220 ( 10 May 2016) to prevent the AnMBR process from failing.	hydraulic overloading,21,42,state	"[{""token"": ""hydraulic overloading"", ""start_span"": 21, ""end_span"": 42, ""type"": ""state""}]"	test
RNA was extracted using the RNeasy MiniKit ( Qiagen) according to manufacturer instructions, with additional steps for cell disruption through flash - freezing and bead - beating filters in mixtures of 500 L RLT buffer, 5 L - mercaptoethanol, and 200 L of mixed 0. 1 mm and 0. 5 mm glass beads ( Biospec products).	mixed,256,261,state	"[{""token"": ""mixed"", ""start_span"": 256, ""end_span"": 261, ""type"": ""state""}]"	test
From the BaCh1 chimney, the following samples were collected: gray ( BaCh1GC) and black ( BaCh1BC) material from the flow channels, white barite from the chimney wall interior ( BaCh1W), and the light yellowish exterior ( BaCh1O).	barite,138,144,state	"[{""token"": ""barite"", ""start_span"": 138, ""end_span"": 144, ""type"": ""state""}]"	train
Caribbean AGMs ( Chlorocebus sabaeus, n = 2) were housed and maintained at the University of Pittsburgh according to the standards of the Association for Assessment and Accreditation of Laboratory Animal Care, and experiments were approved by the University of Pittsburgh Institutional Animal Care and Use Committee ( IACUC).	Caribbean,0,9,state	"[{""token"": ""Caribbean"", ""start_span"": 0, ""end_span"": 9, ""type"": ""state""}]"	train
The retention time of the semicontinuous reactor was maintained at 6 days by pumping conversion residue into the reactor, pumping reactor effluent from the reactor once per hour, and maintaining a liquid volume of 150ml in the reactor.	semicontinuous,26,40,state	"[{""token"": ""semicontinuous"", ""start_span"": 26, ""end_span"": 40, ""type"": ""state""}]"	train
Once recovered, colonies were isolated using an inoculating loop and rinsed twice with 0. 2 m - filtered surface seawater prior to all analyses.	colonies,16,24,state	"[{""token"": ""colonies"", ""start_span"": 16, ""end_span"": 24, ""type"": ""state""}]"	train
Initial partial pressure of CO in the headspace of the reactor was 0kPa.	0kPa,67,71,state	"[{""token"": ""0kPa"", ""start_span"": 67, ""end_span"": 71, ""type"": ""state""}]"	train
Using the total DNA isolated from the methanogenic communities as template, the hypervariable V3V4 region of the 16S rRNA gene was amplified by PCR.	methanogenic,38,50,state	"[{""token"": ""methanogenic"", ""start_span"": 38, ""end_span"": 50, ""type"": ""state""}]"	train
As is common in many Lepidoptera [ 32], G. mellonella adults lack functional mouthparts and therefore additional microbes cannot be acquired during adult life.	adults,54,60,state	"[{""token"": ""adults"", ""start_span"": 54, ""end_span"": 60, ""type"": ""state""}]"	train
Sodium azide was added to the artificial sea water for the control columns at 0. 1%.	control,59,66,state	"[{""token"": ""control"", ""start_span"": 59, ""end_span"": 66, ""type"": ""state""}]"	train
The rhizoplane with soil particles strongly attached to the root surface were sampled at anthesis for DNA extraction ( BBCH6569, reached on May 22, 2013 in both the ambient and elevated CO2 treatments).	anthesis,89,97,state	"[{""token"": ""anthesis"", ""start_span"": 89, ""end_span"": 97, ""type"": ""state""}]"	train
Introduction Sourdough positively influences the sensory, nutritional, textural, and shelf - life features of leavened baked goods ( De Vuyst et al., 2009; Gobbetti et al., 2014).	leavened,110,118,state	"[{""token"": ""leavened"", ""start_span"": 110, ""end_span"": 118, ""type"": ""state""}]"	train
Each plot contained 1 - 4 adult H. squamatum individuals at the time of experimental set - up.	adult,26,31,state	"[{""token"": ""adult"", ""start_span"": 26, ""end_span"": 31, ""type"": ""state""}]"	train
We assembled full - length HIV - 1 genomes from matched cervicovaginal lavage ( CVL) samples and plasma.	HIV - 1,27,34,state	"[{""token"": ""HIV - 1"", ""start_span"": 27, ""end_span"": 34, ""type"": ""state""}]"	train
For intracerebral infection, mice were injected with ~ 20 L via insulin syringe ( 29 G needle) with undiluted virus or RD control media stock into the right hemisphere just anterior to lamboid suture.	intracerebral infection,4,27,state	"[{""token"": ""intracerebral infection"", ""start_span"": 4, ""end_span"": 27, ""type"": ""state""}]"	train
Non - bioaugmented control bottles fed with steam - exploded birch ( pretreated + 0%) were prepared with the same amount of steam - exploded material and inoculum.	Non - bioaugmented,0,18,state	"[{""token"": ""Non - bioaugmented"", ""start_span"": 0, ""end_span"": 18, ""type"": ""state""}]"	train
16S rRNA gene amplicon sequences from the full - scale installations are deposited under EMBL - EBI project accession number PRJEB27163 and PRJEB32000.	full - scale,42,54,state	"[{""token"": ""full - scale"", ""start_span"": 42, ""end_span"": 54, ""type"": ""state""}]"	train
Assuming steady - state degradation, this would equate to a daily organic loading of 0. 23kg COD / ( m3day), and is representative of a low - strength municipal wastewater.	steady - state degradation,9,35,state	"[{""token"": ""steady - state degradation"", ""start_span"": 9, ""end_span"": 35, ""type"": ""state""}]"	train
The rhizosphere samples were thereafter transported to the laboratory on ice and stored at 4 C, and rhizosphere DNA was extracted within the following two weeks from 1 g subsamples containing a mixture of H. squamatum fine roots and rhizospheric soil adhering to them, in order to assess the impact of the climate manipulation treatments on both the radical and extraradical phases of the ectomycorrhizal mycelium.	ectomycorrhizal,389,404,state	"[{""token"": ""ectomycorrhizal"", ""start_span"": 389, ""end_span"": 404, ""type"": ""state""}]"	train
Prior to afforestation, the vegetation type was Arachis hypogaea ( peanut) farmland, and the site information was shown in Table 1.	afforestation,9,22,state	"[{""token"": ""afforestation"", ""start_span"": 9, ""end_span"": 22, ""type"": ""state""}]"	train
None of the subjects were on anti - inflammatory or antioxidant drugs.	None of the subjects were on anti - inflammatory or antioxidant drugs,0,69,state	"[{""token"": ""None of the subjects were on anti - inflammatory or antioxidant drugs"", ""start_span"": 0, ""end_span"": 69, ""type"": ""state""}]"	train
The atmospheric CO2 concentration was elevated to approximately 700ppm during daylight hours in six OTCs ( elevated CO2 treatment), while in another six OTCs, the plants were exposed to the ambient, approximately 400ppm, atmospheric [ CO2] ( ambient CO2 treatment).	atmospheric CO2 concentration was elevated to approximately 700ppm,4,70,state	"[{""token"": ""atmospheric CO2 concentration was elevated to approximately 700ppm"", ""start_span"": 4, ""end_span"": 70, ""type"": ""state""}]"	train
Fermentation of CO in batch reactor with continuous CO supply The setup of the batch reactor is illustrated in Additional file 1: Figure S1.	Fermentation of CO,0,18,state	"[{""token"": ""Fermentation of CO"", ""start_span"": 0, ""end_span"": 18, ""type"": ""state""}]"	train
MPO activity ( indicated as arbitrary units U / g. s) was calculated as mean absorbance ( 460nm) per incubation time per protein content of the sample in grams determined by BCA assay ( ThermoFisher, Rockford, USA).	MPO activity,0,12,state	"[{""token"": ""MPO activity"", ""start_span"": 0, ""end_span"": 12, ""type"": ""state""}]"	train
Of the 91 enrolled women, only 87 ( 95. 6%) were finally included as each had 12, 161 reads, as outlined in the results section, for 16S rRNA sequence analysis.	women,19,24,state	"[{""token"": ""women"", ""start_span"": 19, ""end_span"": 24, ""type"": ""state""}]"	train
Bottles without hNRB inoculum were also prepared.	without hNRB inoculum,8,29,state	"[{""token"": ""without hNRB inoculum"", ""start_span"": 8, ""end_span"": 29, ""type"": ""state""}]"	train
The temperature was kept constant at 21 1C.	21 1C,37,42,state	"[{""token"": ""21 1C"", ""start_span"": 37, ""end_span"": 42, ""type"": ""state""}]"	train
Aqueous Geochemistry After thawing of the frozen cryoconite hole material, the meltwater derived from the ice fractions within the samples were filtered through 0. 22 m single - use syringe filters ( Millipore).	frozen,42,48,state	"[{""token"": ""frozen"", ""start_span"": 42, ""end_span"": 48, ""type"": ""state""}]"	train
Sequencing and immune cell analyses were performed blinded with respect to patient phenotype.	patient,75,82,state	"[{""token"": ""patient"", ""start_span"": 75, ""end_span"": 82, ""type"": ""state""}]"	train
The composition of the fermentation gas was analyzed using an HPR20 mass spectrometer ( Hiden, England) with QGA version 1. 37.	fermentation gas,23,39,state	"[{""token"": ""fermentation gas"", ""start_span"": 23, ""end_span"": 39, ""type"": ""state""}]"	train
This EPR volcanic eruption was dated around the end of 2005 / early 2006 ( Rubin et al., 2006; Tolstoy et al., 2006; Soule et al., 2007), indicating that the Tamtown Basalt collected was 58 months - old.	EPR volcanic eruption,5,26,state	"[{""token"": ""EPR volcanic eruption"", ""start_span"": 5, ""end_span"": 26, ""type"": ""state""}]"	train
The lactate - rich artificial medium was a modified M9 medium [ 18] in which MgSO4 was replaced by MgCl2 ( 190mg / L) and no glucose was added.	lactate - rich,4,18,state	"[{""token"": ""lactate - rich"", ""start_span"": 4, ""end_span"": 18, ""type"": ""state""}]"	train
RNA was extracted from the same anaerobic reactor 2 days after the DNA extraction.	anaerobic,32,41,state	"[{""token"": ""anaerobic"", ""start_span"": 32, ""end_span"": 41, ""type"": ""state""}]"	train
Written informed consent was obtained from all participants following the explanation of the nature and possible consequences of the study; all the participants were 18 years of age or older.	18 years of age or older,166,190,state	"[{""token"": ""18 years of age or older"", ""start_span"": 166, ""end_span"": 190, ""type"": ""state""}]"	train
To assess the representation of the SD rat gut microbiome in the non - redundant gene set, we aligned the ORFs against the SE100 reads from all 245 samples in 7 groups across the 5 collection TPs, using SOAPaligner2 with a 90% identity threshold.	SD,36,38,state	"[{""token"": ""SD"", ""start_span"": 36, ""end_span"": 38, ""type"": ""state""}]"	train
Carbon Dioxide Analysis Produced gas samples were collected from the Marcellus - 4 natural - gas well over a period of 140 days.	Carbon Dioxide,0,14,state	"[{""token"": ""Carbon Dioxide"", ""start_span"": 0, ""end_span"": 14, ""type"": ""state""}]"	train
Ten chicks in the experimental group were reared in a single cage together with a 45 - week - old hen.	together with a 45 - week - old hen,66,101,state	"[{""token"": ""together with a 45 - week - old hen"", ""start_span"": 66, ""end_span"": 101, ""type"": ""state""}]"	train
To set up comparative analyses, beach sand was collected from a beach in Orange Beach, AL that was severely impacted by oil contamination following the DWH spill and a beach on St. George Island, FL where negligible contamination was detected in the months following the blowout.	DWH spill,152,161,state	"[{""token"": ""DWH spill"", ""start_span"": 152, ""end_span"": 161, ""type"": ""state""}]"	train
Three samples were mixed ( 50g of 1922 mbsf lignite, 10g of 1978 mbsf sandstone, and 50g of 1978 mbsf lignite) with 890ml anaerobic medium ( described below) without any organic substances.	anaerobic medium,122,138,state	"[{""token"": ""anaerobic medium"", ""start_span"": 122, ""end_span"": 138, ""type"": ""state""}]"	train
All inocula were prepared in an anaerobic glove box at dilutions of 0. 01, 0. 1, 1, 10, and 25% ( w / v) in PBS medium.	anaerobic,32,41,state	"[{""token"": ""anaerobic"", ""start_span"": 32, ""end_span"": 41, ""type"": ""state""}]"	train
35. 69N 93. 00E 3. 85 m below sediment surface Saline October 28, 2010 SSL Shisanling Reservoir in Beijing 40. 26N 116. 25E Surface sediment Freshwater October 1, 2012 B43 Yellow Sea 38. 10N 122. 00E Surface sediment Seawater August 12, 2011 B46 Yellow Sea 37. 90N 122. 50E Surface sediment Seawater August 12, 2011 DHa - 1 East China Sea 30. 50N 122. 50E Surface sediment Seawater August 14, 2011 DW03 South China Sea 2. 95N 105. 84E Water sample Seawater July 13, 2012 Locations of water and sediment samples used in this study.	Saline,47,53,state	"[{""token"": ""Saline"", ""start_span"": 47, ""end_span"": 53, ""type"": ""state""}]"	train
The pooled FAM - labelled amplicons of cel5 and cel48 were purified with QIAquick gel extraction kit ( Qiagen, Hilden, Germany) and digested overnight at 37C with restriction enzyme MboI ( New England Biolabs, Wilbury Way Hitchin, Herts, UK) and AluI ( Fermentas, Thermo Fisher Scientific, Hudson, NH, USA).	37C,154,157,state	"[{""token"": ""37C"", ""start_span"": 154, ""end_span"": 157, ""type"": ""state""}]"	train
These studies employed a down - flow hanging sponge ( DHS) reactor system, which was originally developed for treating municipal sewage in developing countries at a low cost22.	DHS,54,57,state	"[{""token"": ""DHS"", ""start_span"": 54, ""end_span"": 57, ""type"": ""state""}]"	train
Surface waters were exclusively collected at the flowing sections of streams to avoid stagnant ponds with biased evaporative signals ( Snchez - Murillo and Birkel, 2016).	stagnant,86,94,state	"[{""token"": ""stagnant"", ""start_span"": 86, ""end_span"": 94, ""type"": ""state""}]"	train
The reactor operated at 40C.	40C,24,27,state	"[{""token"": ""40C"", ""start_span"": 24, ""end_span"": 27, ""type"": ""state""}]"	train
Chemical analyses During the incubation period, microcosm headspaces were routinely monitored for methane production by gas chromatography ( GC; Fowler et al., 2012).	methane,98,105,state	"[{""token"": ""methane"", ""start_span"": 98, ""end_span"": 105, ""type"": ""state""}]"	train
Additionally, bulk seawater from 25 m depth was collected for comparison with Trichodesmium colony DNA.	25 m depth,33,43,state	"[{""token"": ""25 m depth"", ""start_span"": 33, ""end_span"": 43, ""type"": ""state""}]"	train
Colonization of Germ - free Mice.	Germ - free,16,27,state	"[{""token"": ""Germ - free"", ""start_span"": 16, ""end_span"": 27, ""type"": ""state""}]"	train
This reactor sustained MCFA production for 252days ( 4).	MCFA,23,27,state	"[{""token"": ""MCFA"", ""start_span"": 23, ""end_span"": 27, ""type"": ""state""}]"	train
Control doughs were prepared without inoculation by using IF ( C - IF) and non - irradiated durum wheat flour ( C).	without inoculation,29,48,state	"[{""token"": ""without inoculation"", ""start_span"": 29, ""end_span"": 48, ""type"": ""state""}]"	train
Contact Lohmann Brown hens acting as a natural source of gut microbiota were obtained from a local commercial egg laying hen farm.	Lohmann Brown,8,21,state	"[{""token"": ""Lohmann Brown"", ""start_span"": 8, ""end_span"": 21, ""type"": ""state""}]"	train
Lake Lustsee is the only one of the northern lakes, which is heavily influenced by groundwater sources.	heavily influenced by groundwater sources,61,102,state	"[{""token"": ""heavily influenced by groundwater sources"", ""start_span"": 61, ""end_span"": 102, ""type"": ""state""}]"	train
Both are equipped with heating aggregates and operated between 42 and 45C.	between 42 and 45C,55,73,state	"[{""token"": ""between 42 and 45C"", ""start_span"": 55, ""end_span"": 73, ""type"": ""state""}]"	train
Stage V is the prepupa that has ceased spinning and stemmatal pigments are not visible.	prepupa,15,22,state	"[{""token"": ""prepupa"", ""start_span"": 15, ""end_span"": 22, ""type"": ""state""}]"	train
The 12 pigs with the highest FCR and the 12 pigs with the lowest were selected for this study.	highest FCR,21,32,state	"[{""token"": ""highest FCR"", ""start_span"": 21, ""end_span"": 32, ""type"": ""state""}]"	train
The accumulation rate of crenarchaeol in Core GC1 was newly estimated in this study from the raw GDGT dataset67, and the GDGT analysis in the Arctic sediments was described elsewhere68.	accumulation rate of crenarchaeol,4,37,state	"[{""token"": ""accumulation rate of crenarchaeol"", ""start_span"": 4, ""end_span"": 37, ""type"": ""state""}]"	train
Fig 2 shows the anode chamber configuration scheme together with the fluid velocity and shear rate internal distributions under the MFCs operational conditions ( influent flow rates of 1. 5 Ld - 1 and recirculation flow rates of 170 Ld - 1).	recirculation flow rates of 170 Ld - 1,201,239,state	"[{""token"": ""recirculation flow rates of 170 Ld - 1"", ""start_span"": 201, ""end_span"": 239, ""type"": ""state""}]"	train
Sodium lactate was added as electron donor at 20 mM. Selenite was added as Na2SeO3 at 5 mM. The reactor was flushed with N2 and then incubated for 21 days at 30C.	30C,158,161,state	"[{""token"": ""30C"", ""start_span"": 158, ""end_span"": 161, ""type"": ""state""}]"	train
Pasteurization temperature was now increased to 95C ( for 20min).	Pasteurization,0,14,state	"[{""token"": ""Pasteurization"", ""start_span"": 0, ""end_span"": 14, ""type"": ""state""}]"	train
On day 0 of the experience, we collected fecal samples from the all rats, and subsequently AIA treatment was instigated by a single subcutaneous injection of 0. 1 mL of complete Freund ' s adjuvant ( CFA) containing 0. 2 mg of Mycobacterium tuberculosis H37Ra ( BD, Sparks, USA) and mineral oils ( Sigma - Aldrich, Milwaukee, USA) into the root of rats ' tails [ 15].	AIA,91,94,state	"[{""token"": ""AIA"", ""start_span"": 91, ""end_span"": 94, ""type"": ""state""}]"	train
DNA extraction and MAG construction Genomic DNA was extracted from subsamples ( ~ 1. 0 g) of the inactive chimney by a modified method using the UltraClean Soil DNA Isolation Kit ( MoBio Laboratories, Carlsbad, CA, USA) as previously described ( 34).	inactive,97,105,state	"[{""token"": ""inactive"", ""start_span"": 97, ""end_span"": 105, ""type"": ""state""}]"	train
In summary, this metagenome project reveals initial insight about the Amazon lakes microbial communities during the flood season.	flood,116,121,state	"[{""token"": ""flood"", ""start_span"": 116, ""end_span"": 121, ""type"": ""state""}]"	train
None of the incubations with antibiotics could use CO or produce methane.	with antibiotics,24,40,state	"[{""token"": ""with antibiotics"", ""start_span"": 24, ""end_span"": 40, ""type"": ""state""}]"	train
Berdugo - Clavijo and Gieg ( 2014) also demonstrated that methanogenic crude oil biodegradation could be established from these produced waters.	methanogenic crude oil biodegradation,58,95,state	"[{""token"": ""methanogenic crude oil biodegradation"", ""start_span"": 58, ""end_span"": 95, ""type"": ""state""}]"	train
The feed intake and body weight of each pig was measured by Osbornes FIRE ( Feed Intake Recording Equipment) System daily.	body weight,20,31,state	"[{""token"": ""body weight"", ""start_span"": 20, ""end_span"": 31, ""type"": ""state""}]"	train
Prior to inoculation with 2mL of the CO - enriched mixed culture derived from sludge, reactors were sparged with N2 ( UHP, Praxair) for 10min and sealed with butyl rubber and aluminum crimps.	CO - enriched,37,50,state	"[{""token"": ""CO - enriched"", ""start_span"": 37, ""end_span"": 50, ""type"": ""state""}]"	train
Enrichment of hNRB in Hungate Tubes hNRB were also cultivated in 20 ml Hungate tubes, containing 12. 5 ml of anoxic CSBK medium amended with 0, 10, 20, 40, or 80 mM nitrate.	nitrate,165,172,state	"[{""token"": ""nitrate"", ""start_span"": 165, ""end_span"": 172, ""type"": ""state""}]"	train
We also obtained two female individuals of Neotoma lepida ( Neotoma is the sister genus of Peromyscus) captured from near White Rocks, Tooele County, Utah ( 4019N, 11254W).	female,21,27,state	"[{""token"": ""female"", ""start_span"": 21, ""end_span"": 27, ""type"": ""state""}]"	train
Interproximal supragingival plaque samples ( interproximal) were collected by inserting the paper point horizontally in the buccallingual direction near the gingival margin.	plaque,28,34,state	"[{""token"": ""plaque"", ""start_span"": 28, ""end_span"": 34, ""type"": ""state""}]"	train
Before use, all animals were tested and confirmed seronegative for Macacine herpes virus 1 ( herpes B), SIV, simian T - lymphotropic virus and simian retrovirus, and were negative for simian retrovirus by PCR as well.	negative for simian retrovirus,171,201,state	"[{""token"": ""negative for simian retrovirus"", ""start_span"": 171, ""end_span"": 201, ""type"": ""state""}]"	train
DNA extraction and 16S rRNA gene amplicon sequencing Samples were collected from the MFC feed ( swine manure) and anode chambers once during steady - state operation ( day 43).	steady - state operation,141,165,state	"[{""token"": ""steady - state operation"", ""start_span"": 141, ""end_span"": 165, ""type"": ""state""}]"	train
To test the direct methanogenesis from CO, methanogenic sludge was incubated with the antibiotics vancomycin ( v) and erythromycin ( e) ( bacterial growth inhibitors): COv50e100 ( 50M vancomycin + 100M erythromycin) and COv100e100 ( 100M of each antibiotic).	methanogenesis,19,33,state	"[{""token"": ""methanogenesis"", ""start_span"": 19, ""end_span"": 33, ""type"": ""state""}]"	train
Sulfide was measured using a Hach DR 900, method 8131.	Sulfide,0,7,state	"[{""token"": ""Sulfide"", ""start_span"": 0, ""end_span"": 7, ""type"": ""state""}]"	train
For analysis of interstitial light hydrocarbon gases, a portion of the deepest section was placed in 500ml gas cannisters containing clean, degassed, and sterilized seawater.	interstitial light hydrocarbon gases,16,52,state	"[{""token"": ""interstitial light hydrocarbon gases"", ""start_span"": 16, ""end_span"": 52, ""type"": ""state""}]"	train
Materials and Methods Site Description and Sample Collection Animal and sediment samples were collected in May 2014 and August 2016 from Cod Cove, Maine ( approximate GPS coordinates 44. 000954, - 69. 639964) during low tide at a site near shore.	during low tide,209,224,state	"[{""token"": ""during low tide"", ""start_span"": 209, ""end_span"": 224, ""type"": ""state""}]"	train
Vegetation is a native grassland and shrubland community dominated by S. tenacissima, and contains gypsophilous shrubs such as H. squamatum and Gypsophila struthium L. Perennial vegetation cover is lower than 40%.	Vegetation,0,10,state	"[{""token"": ""Vegetation"", ""start_span"": 0, ""end_span"": 10, ""type"": ""state""}]"	train
Metagenomes were prepared from sludge obtained from the anaerobic digester tank at Fredericia wastewater treatment plant in Denmark.	anaerobic,56,65,state	"[{""token"": ""anaerobic"", ""start_span"": 56, ""end_span"": 65, ""type"": ""state""}]"	train
AH was stimulated initially at 21C with a relative humidity of 90%.	AH,0,2,state	"[{""token"": ""AH"", ""start_span"": 0, ""end_span"": 2, ""type"": ""state""}]"	train
We knocked down lysozyme expression using RNAi in insect hosts that were colonized by either E. mundtii strain G2 - mun +, which produces the broad - spectrum bacteriocin mundticin [ 34], or by E. mundtii strain G2 - mun -, which is unable to express the mundticin - encoding gene munA. To test the impact of these manipulations we cured the gut microbiota from final - instar larvae using antibiotics and re - inoculated these individuals with either E. mundtii G2 - mun + or G2 - mun -, and reared them on conventional non - sterile diet until pupation.	instar larvae,370,383,state	"[{""token"": ""instar larvae"", ""start_span"": 370, ""end_span"": 383, ""type"": ""state""}]"	train
Methods Granular Sludge All granular sludges were collected from full - scale reactors in The Netherlands.	full - scale,65,77,state	"[{""token"": ""full - scale"", ""start_span"": 65, ""end_span"": 77, ""type"": ""state""}]"	train
Voltage was added to the circuit using a power supply ( model 1665; BK Precision, Yorba Linda, CA, USA), with reactors operated in fed - batch mode.	fed - batch mode,131,147,state	"[{""token"": ""fed - batch mode"", ""start_span"": 131, ""end_span"": 147, ""type"": ""state""}]"	train
On day 14, the fermenter was inoculated with slurry from existing biogas plants.	biogas,66,72,state	"[{""token"": ""biogas"", ""start_span"": 66, ""end_span"": 72, ""type"": ""state""}]"	train
The additional factors alkalinity ( alkal), nitrate ( NO3), sulfate ( SO4), chloride ( Cl -), ammonium ( NH4), sodium ( Na), potassium ( K), magnesium ( Mg), calcium ( Ca), dissolved reactive silica ( DRSi), total phosphorous ( TP), dissolved organic carbon ( DOC), dissolved nitrogen ( DN), and dissolved phosphorous ( DP) were only measured once for each lake as seasonal fluctuations were considered to be small and largely within the measurement errors ( Landesregierung, 2009).	seasonal,365,373,state	"[{""token"": ""seasonal"", ""start_span"": 365, ""end_span"": 373, ""type"": ""state""}]"	train
Unless otherwise specified, virus infections were performed on two day - old mice.	two day - old,63,76,state	"[{""token"": ""two day - old"", ""start_span"": 63, ""end_span"": 76, ""type"": ""state""}]"	train
Samples for water stable isotope analysis were collected in 30 mL glass E - C borosilicate bottles with tetrafluoroethylene ( TFE) - lined caps ( Wheaton Science Products, USA).	stable isotope,18,32,state	"[{""token"": ""stable isotope"", ""start_span"": 18, ""end_span"": 32, ""type"": ""state""}]"	train
The new pupa is classed as stage VI; the cuticle has not sclerotized and is completely white.	pupa,8,12,state	"[{""token"": ""pupa"", ""start_span"": 8, ""end_span"": 12, ""type"": ""state""}]"	train
Inoculation with bacterial mass collected from WCHA and YCFA agars To obtain bacterial mass growing on WCHA and YCFA agars, the caecal content of a 45 - week - old hen was resuspended in pre - reduced anaerobically sterilised dilution blank ( PRAS0. 1 g magnesium sulfate heptahydrate, 0. 2 g monobasic potassium phosphate, 0. 2 g potassium chloride, 1. 15 g dibasic sodium phosphate, 3. 0 g sodium chloride, 1. 0 g sodium thioglycolate, 0. 5 g L - cysteine, 1000 ml distilled water, pH 7. 5 at 25C), tenfold serially diluted and plated on WCHA or YCFA agars.	45 - week - old,148,163,state	"[{""token"": ""45 - week - old"", ""start_span"": 148, ""end_span"": 163, ""type"": ""state""}]"	train
Materials and methods Field site and sampling The samples used in this study were collected during summer ( July 12 and 13, 2012, lake surface elevation: 1945 m) following a winter when the lake did not mix fully ( the onset of meromixis).	onset of meromixis,219,237,state	"[{""token"": ""onset of meromixis"", ""start_span"": 219, ""end_span"": 237, ""type"": ""state""}]"	train
All participants were periodontally healthy.	periodontally healthy,22,43,state	"[{""token"": ""periodontally healthy"", ""start_span"": 22, ""end_span"": 43, ""type"": ""state""}]"	train
Pore - water samples for sulfate and dissolved inorganic carbon ( DIC) analysis were extracted from the intact sediment core via Rhizon suction samplers ( 0. 1 m porous polymer, Rhizosphere Research, Wageningen, Netherlands), pretreated as described previously ( Glombitza et al., 2014).	sulfate,25,32,state	"[{""token"": ""sulfate"", ""start_span"": 25, ""end_span"": 32, ""type"": ""state""}]"	train
The samples of the healthy controls ( HCs) ( n = 30) were collected during routine physical examination at the Liaoning International Travel Health Care Center, Dalian, China.	healthy,19,26,state	"[{""token"": ""healthy"", ""start_span"": 19, ""end_span"": 26, ""type"": ""state""}]"	train
Their geochemical composition indicates subseafloor mixing of at least 10% high - temperature ( 320C) hydrothermal fluids and cold ( 0. 7C) percolating seawater, combined with subsequent modification due to microbial sulfate reduction ( Eickmann et al., 2014).	microbial sulfate reduction,207,234,state	"[{""token"": ""microbial sulfate reduction"", ""start_span"": 207, ""end_span"": 234, ""type"": ""state""}]"	train
When volatile fatty acids ( VFAs) were further added as substrates, utilization rates were reduced and an accumulation of propionate was observed ( Cetecioglu et al. 2015a; Cetecioglu et al. 2013; Cetecioglu et al. 2015b).	propionate,122,132,state	"[{""token"": ""propionate"", ""start_span"": 122, ""end_span"": 132, ""type"": ""state""}]"	train
Following the third ABX treatment ( six weeks old), mice were administered HDM for five weeks according to the model described earlier.	ABX treatment,20,33,state	"[{""token"": ""ABX treatment"", ""start_span"": 20, ""end_span"": 33, ""type"": ""state""}]"	train
At each sample collection timepoint except for the hatch timepoint, 30 birds were randomly selected, necropsied and examined for grossly evident lesions.	hatch,51,56,state	"[{""token"": ""hatch"", ""start_span"": 51, ""end_span"": 56, ""type"": ""state""}]"	train
This included one site from a glacial moraine ( BBM) and another from an organic - rich tundra ( SN), which has been studied in detail ( Tveit et al., 2013).	organic - rich,73,87,state	"[{""token"": ""organic - rich"", ""start_span"": 73, ""end_span"": 87, ""type"": ""state""}]"	train
In a previous study [ 6], the optimal steam - explosion conditions of birch for biogas production were found to be pretreatment at 210C and 10 - min residence time.	biogas,80,86,state	"[{""token"": ""biogas"", ""start_span"": 80, ""end_span"": 86, ""type"": ""state""}]"	train
Chicks in the control group were kept under the same conditions but without any treatment.	without any treatment,68,89,state	"[{""token"": ""without any treatment"", ""start_span"": 68, ""end_span"": 89, ""type"": ""state""}]"	train
The oxygen concentration in the bottom water directly above the sediment core was determined by Winkler titration ( Grasshoff et al., 1983).	oxygen concentration,4,24,state	"[{""token"": ""oxygen concentration"", ""start_span"": 4, ""end_span"": 24, ""type"": ""state""}]"	train
One part was air - dried for analysis of soil characteristics, including soil pH, the contents of total carbon ( C), total nitrogen ( N), and available phosphorus ( P).	pH,78,80,state	"[{""token"": ""pH"", ""start_span"": 78, ""end_span"": 80, ""type"": ""state""}]"	train
For butyric acid degradation, since no genome - scale model of known butyric acid - oxidizing bacteria is available yet, we augmented model iSfu648 by the reactions catalyzed by the butyryl - CoA synthetase and the acetyl - CoA acetyltransferase, added butyric acid uptake via a proton symport, and enforced the excretion of 97. 9% of the carbon influx as acetic acid, using the same ratio that the model predicted for growth on propionic acid.	butyric acid degradation,4,28,state	"[{""token"": ""butyric acid degradation"", ""start_span"": 4, ""end_span"": 28, ""type"": ""state""}]"	train
All infected chicks and the contact donor hen were sacrificed 4 days later ( Fig 1).	infected,4,12,state	"[{""token"": ""infected"", ""start_span"": 4, ""end_span"": 12, ""type"": ""state""}]"	train
The cultivar Kathleen is a sixrow winter barley cultivar with very high grain yield, resistance to mildew, brown rust, and barley yellow mosaic viruses.	very high grain yield,62,83,state	"[{""token"": ""very high grain yield"", ""start_span"": 62, ""end_span"": 83, ""type"": ""state""}]"	train
In addition, a group of AIA rats were fed a high - fat diet ( D12492).	AIA,24,27,state	"[{""token"": ""AIA"", ""start_span"": 24, ""end_span"": 27, ""type"": ""state""}]"	train
Using stool from five healthy non - HMP donors, we compared fungal diversity and taxonomy using the HMP method of microbial DNA extraction ( MO BIO PowerSoil DNA Isolation Kit) and a modified version of this protocol that is similar to what other investigators have used [ 21, 38, 54, 55].	healthy,22,29,state	"[{""token"": ""healthy"", ""start_span"": 22, ""end_span"": 29, ""type"": ""state""}]"	train
The temperature of the reactor was controlled at 35C using a water bath, and the pH of the reactor was maintained at 5. 5 by feeding 5M KOH through a pump connected to a pH controller.	35C,49,52,state	"[{""token"": ""35C"", ""start_span"": 49, ""end_span"": 52, ""type"": ""state""}]"	train
Total dissolved nitrogen ( TDN) was analyzed in samples from all wells by a Shimadzu TOC / TN analyzer ( see above), employing appropriate dilutions as needed for samples.	TN,91,93,state	"[{""token"": ""TN"", ""start_span"": 91, ""end_span"": 93, ""type"": ""state""}]"	train
Bacterial Isolation Marinobacter sp. UTICA - S1B6 was recovered from produced fluid collected from a Utica - Point Pleasant natural - gas well ( Utica - 3) on the first day of flowback using Difco Marine Broth 2216 ( DM2216) medium supplemented with 40 mM nitrate at 30C ( Figure 1, Tummings et al., 2018).	first day of flowback,163,184,state	"[{""token"": ""first day of flowback"", ""start_span"": 163, ""end_span"": 184, ""type"": ""state""}]"	train
Novel molecular markers for the detection of methanogens and phylogenetic analyses of methanogenic communities Methanogenic Archaea produce approximately one billion tons of methane annually, but their biology remains largely unknown.	methane,174,181,state	"[{""token"": ""methane"", ""start_span"": 174, ""end_span"": 181, ""type"": ""state""}]"	train
Sea surface temperature ( SST) and surface chlorophyll fluorescence ( Chl) were measured at 25 m depth using conductivity - temperature - depth sensors.	25 m depth,92,102,state	"[{""token"": ""25 m depth"", ""start_span"": 92, ""end_span"": 102, ""type"": ""state""}]"	train
In the initial hours of the cycle, DO was below 0. 5mg / L due to intensive usage of oxygen for organics and ammonium oxidation but increased from the fourth hour of the cycle and stabilized at 6mg / L until the end of the cycle.	ammonium oxidation,109,127,state	"[{""token"": ""ammonium oxidation"", ""start_span"": 109, ""end_span"": 127, ""type"": ""state""}]"	train
Arthritis was induced by injection of CFA on day 0 after fecal sample collection; fecal samples were collected for five time points ( TP) on day 0 ( TP1), day 7 ( TP2), day 14 ( TP3), day 21 ( TP4), and day 30 ( TP5).	Arthritis,0,9,state	"[{""token"": ""Arthritis"", ""start_span"": 0, ""end_span"": 9, ""type"": ""state""}]"	train
The sludge ( 13. 5 g / L wet sludge) was incubated in a 500 ml batch reactor with anaerobic mineral medium ( pH = 7. 3) containing the following components: 5. 6 mM NH4Cl, 0. 1 mM CaCl2. 2H2O, 1. 8 mM KH2PO4, 2. 0 mM Na2HPO4, and 3. 3.	anaerobic,82,91,state	"[{""token"": ""anaerobic"", ""start_span"": 82, ""end_span"": 91, ""type"": ""state""}]"	train
Childhood Autism Rating Scale ( CARS) scores [ 60] were calculated by an experienced child neuropsychiatrist.	Childhood Autism,0,16,state	"[{""token"": ""Childhood Autism"", ""start_span"": 0, ""end_span"": 16, ""type"": ""state""}]"	train
Twelve chicks in the experimental group were reared in a single cage with a 34 - week - old hen.	single cage with a 34 - week - old hen,57,95,state	"[{""token"": ""single cage with a 34 - week - old hen"", ""start_span"": 57, ""end_span"": 95, ""type"": ""state""}]"	train
Seawater temperature around the WAP ranged from 1. 8C to 2C, although summer warming episodes have been reported for South Bay ( Crdenas, Gonzlez - Aravena & Santibaez, 2018).	summer warming episodes,70,93,state	"[{""token"": ""summer warming episodes"", ""start_span"": 70, ""end_span"": 93, ""type"": ""state""}]"	train
House Dust Mite ( HDM) Model The HDM model of AAD was developed by Bracken et al ( 15).	AAD,46,49,state	"[{""token"": ""AAD"", ""start_span"": 46, ""end_span"": 49, ""type"": ""state""}]"	train
Physicochemical parameters of the biogas reactors Sample ID Day MSL ( tmonth1) DPM ( tmonth1) CM ( tmonth1) OLR ( kg oTSm3d1) CH4calc.	biogas,34,40,state	"[{""token"": ""biogas"", ""start_span"": 34, ""end_span"": 40, ""type"": ""state""}]"	train
For bacterial DNA extraction a total of 1 L of water from each lake was used, mixing samples taken in 1 m steps from the entire water column over the deepest point of the lake.	deepest,150,157,state	"[{""token"": ""deepest"", ""start_span"": 150, ""end_span"": 157, ""type"": ""state""}]"	train
Another 10l of blood sample was used for ketone bodies level measurement using a STAT - Site M ( - Hydroxybutyrate) meter and a test strip ( Standbio Ketosite STAT - Site M - HB, Boerne, TX, USA).	ketone bodies level,41,60,state	"[{""token"": ""ketone bodies level"", ""start_span"": 41, ""end_span"": 60, ""type"": ""state""}]"	train
Illumina MiSeq sequencing and data analysis After isolation of microbial DNA from Italian feces using repeated bead beating55 as in Schnorr et al. 2, the V3 - V4 hypervariable region of the 16S rRNA gene was amplified using the 341F and 805R primers with added Illumina adapter overhang sequences as previously reported56.	Italian,82,89,state	"[{""token"": ""Italian"", ""start_span"": 82, ""end_span"": 89, ""type"": ""state""}]"	train
For patients undergoing endoscopic evaluation, cells isolated from mucosal biopsies were obtained and stored at 160C until further analyses.	patients,4,12,state	"[{""token"": ""patients"", ""start_span"": 4, ""end_span"": 12, ""type"": ""state""}]"	train
Enrichment of hNRB in Microcosms hNRB were enriched in 125 ml serum bottles, containing 44 ml of anoxic CSBK medium ( Supplementary Table S1) amended with 0, 10, 20, 40, or 80 mM nitrate.	nitrate,179,186,state	"[{""token"": ""nitrate"", ""start_span"": 179, ""end_span"": 186, ""type"": ""state""}]"	train
The second part was stored at 4C for DOC analysis, and the third part was stored at 80C for DNA extraction.	DOC,37,40,state	"[{""token"": ""DOC"", ""start_span"": 37, ""end_span"": 40, ""type"": ""state""}]"	train
Ten chicks were orally inoculated with 0. 1 ml of suspension collected from WCHA agar, another group of 10 chicks was inoculated with the suspension collected from YCFA agar and the last 10 chicks served as a non - inoculated control.	non - inoculated,209,225,state	"[{""token"": ""non - inoculated"", ""start_span"": 209, ""end_span"": 225, ""type"": ""state""}]"	train
To minimize competition for limited substrates between different microbial groups ( e. g., sulfate - reducing and fermentative bacteria) the slurries were amended with a combination of six low - molecular - weight organic acids ( acetate, butyrate, formate, lactate, propionate, and succinate), each at a final concentration of 5mM. Slurries were pasteurized at 80C for 1h to eliminate viable vegetative cells and were incubated at 50C immediately afterwards to promote germination and growth of thermophilic endospores.	50C,432,435,state	"[{""token"": ""50C"", ""start_span"": 432, ""end_span"": 435, ""type"": ""state""}]"	train
Biogas production was determined by measuring the pressure build up with a pressure - meter ( WAL - BMP - Test system 3150, WAL, Germany) and normalizing to standard conditions ( 0C; 1. 0 atm).	Biogas production,0,17,state	"[{""token"": ""Biogas production"", ""start_span"": 0, ""end_span"": 17, ""type"": ""state""}]"	train
Trichodesmium colonies were collected using a 202 m plankton net which was hand - towed at < 2 km h1 through near - surface waters ( < 10 m depth) for 1015 min.	colonies,14,22,state	"[{""token"": ""colonies"", ""start_span"": 14, ""end_span"": 22, ""type"": ""state""}]"	train
All the marine isolates obtained were able to grow on MA at 22 C, hence these culture conditions were selected as standard for laboratory maintenance and assays.	marine,8,14,state	"[{""token"": ""marine"", ""start_span"": 8, ""end_span"": 14, ""type"": ""state""}]"	train
Sulfide measurements were conducted on unfiltered samples ( Hach method 8131, see following section).	Sulfide,0,7,state	"[{""token"": ""Sulfide"", ""start_span"": 0, ""end_span"": 7, ""type"": ""state""}]"	train
At each time point of fermentation, three bottles were removed, the water kefirs were sieved, and the water kefir grains were washed with sterile saline ( 0. 85%, m / v, NaCl; Merck, Darmstadt, Germany) and stored at - 20C.	fermentation,22,34,state	"[{""token"": ""fermentation"", ""start_span"": 22, ""end_span"": 34, ""type"": ""state""}]"	train
Cluster analyses ( based on SSU V9 ( eukaryotic) and V4 ( prokaryotic) OTU composition) grouped samples according to their origin followed by separation into seasonal clusters, indicating that each lake has a unique signature based on OTU composition.	seasonal,158,166,state	"[{""token"": ""seasonal"", ""start_span"": 158, ""end_span"": 166, ""type"": ""state""}]"	train
End point crude oil subsamples ( 1 mL) were collected from oil - amended cultures and sterile controls for hydrocarbon analysis.	hydrocarbon,107,118,state	"[{""token"": ""hydrocarbon"", ""start_span"": 107, ""end_span"": 118, ""type"": ""state""}]"	train
Very high concentrations of pollutants in the digestate made it necessary to dilute the digestate prior to introduction to the biological reactor.	Very high concentrations of pollutants,0,38,state	"[{""token"": ""Very high concentrations of pollutants"", ""start_span"": 0, ""end_span"": 38, ""type"": ""state""}]"	train
All the RNA samples were sequenced single - end ( 75bp) using NextSeq 500 system ( Illumina, San Diego, CA).	single,35,41,state	"[{""token"": ""single"", ""start_span"": 35, ""end_span"": 41, ""type"": ""state""}]"	train
A Kovacs ice drill was used to remove the ice layer and the frozen cryoconite hole sediment was excavated through the drilling and scooped from the surface debris into the tubes using a sterilized ice scoop.	frozen,60,66,state	"[{""token"": ""frozen"", ""start_span"": 60, ""end_span"": 66, ""type"": ""state""}]"	train
The composition of the medium for the DHS reactor was as follows ( l1): 5. 9mg sodium acetate, 7. 3mg sodium propionate, 8. 7mg sodium butyrate, 10mg yeast extract, 0. 53g NH4Cl, 0. 1g KH2PO4, 4g MgCl26H2O, 1g CaCl22H2O, 20g NaCl, 2g NaHCO3, 0. 1g Na2S9H2O, 2ml Ti ( III) - nitrilotriacetate, 1ml trace element solution75, 1ml vitamin solution76, and 1ml resazurin solution ( 1mgml1).	DHS,38,41,state	"[{""token"": ""DHS"", ""start_span"": 38, ""end_span"": 41, ""type"": ""state""}]"	train
Marine datasets include Aegean, Ionian, and Marmara Sea deep datasets, and Puerto Rico Trench deep dataset, together with three of the deep MALASPINA datasets also used for assembly.	Marine,0,6,state	"[{""token"": ""Marine"", ""start_span"": 0, ""end_span"": 6, ""type"": ""state""}]"	train
To identify bacterial taxa whose relative abundances were influenced by the micronutrient deficiency treatments, we rarefied the abundance table to 7, 000 reads per sample and used linear mixed - effects models of log - transformed abundances ( plus one pseudo - count).	micronutrient deficiency,76,100,state	"[{""token"": ""micronutrient deficiency"", ""start_span"": 76, ""end_span"": 100, ""type"": ""state""}]"	train
Materials and methods Sample collection Eighty adult treefrogs ( Polypedates megacephalus) were collected from New Taipei City and Taichung City, Taiwan.	adult,47,52,state	"[{""token"": ""adult"", ""start_span"": 47, ""end_span"": 52, ""type"": ""state""}]"	train
Materials and Methods Sampling The hydrothermally - inactive sulfide chimney ( named IPdc, Fig. S1) was collected at the Pika site ( 40) ( 1255. 130N, 14338. 972E, a water depth of 2787 m) in the SMT using a remotely operated vehicle ( ROV) Hyper - Dolphin ( JAMSTEC, Japan) during the NT12 - 24 sampling cruise with the research vessel ( R / V) Natsushima ( JAMSTEC).	hydrothermally - inactive,35,60,state	"[{""token"": ""hydrothermally - inactive"", ""start_span"": 35, ""end_span"": 60, ""type"": ""state""}]"	train
Color shades of the circles indicate the number of oil - qualified extracts ( n = 0, 1, 2, 3) in the sediment core for that location.	oil,51,54,state	"[{""token"": ""oil"", ""start_span"": 51, ""end_span"": 54, ""type"": ""state""}]"	train
Two not inoculated controls were prepared, one of which using IF ( C - IF) and the other using non - irradiated flour ( C).	not inoculated,4,18,state	"[{""token"": ""not inoculated"", ""start_span"": 4, ""end_span"": 18, ""type"": ""state""}]"	train
Alpha - amylase activity The alpha - amylase activity of the flour, before and after irradiation, was estimated through determination of the falling number.	alpha - amylase activity,29,53,state	"[{""token"": ""alpha - amylase activity"", ""start_span"": 29, ""end_span"": 53, ""type"": ""state""}]"	train
Mouse litters were randomly assigned to experimental groups.	litters,6,13,state	"[{""token"": ""litters"", ""start_span"": 6, ""end_span"": 13, ""type"": ""state""}]"	train
After hand washing, women were instructed to insert the swab into their vaginas to the half - way point on the handle, rotate the swab 3 times, remove the swab and place it into the provided collection tube, break off the handle, leaving the swab head in the reagent tube, and close and date the tube.	women,20,25,state	"[{""token"": ""women"", ""start_span"": 20, ""end_span"": 25, ""type"": ""state""}]"	train
The bioreactors were then inoculated with 1% drainage water from the study area called Mrmes, which is located in the Vulkaneifel ( Germany) and is influenced by nitrate - rich water from agricultural drainage.	nitrate - rich,162,176,state	"[{""token"": ""nitrate - rich"", ""start_span"": 162, ""end_span"": 176, ""type"": ""state""}]"	train
After the first 30days ( P0) of the reactor operation, HA addition and inhibition mitigation experiments were started when the methane production stabilised.	methane,127,134,state	"[{""token"": ""methane"", ""start_span"": 127, ""end_span"": 134, ""type"": ""state""}]"	train
Materials and Methods In this metagenomic study of subjects with advanced dementia, four analyses were performed.	advanced dementia,65,82,state	"[{""token"": ""advanced dementia"", ""start_span"": 65, ""end_span"": 82, ""type"": ""state""}]"	train
Buccal and lingual plaque samples ( buccal / lingual) were taken from the area close to the gingival margin.	plaque,19,25,state	"[{""token"": ""plaque"", ""start_span"": 19, ""end_span"": 25, ""type"": ""state""}]"	train
The study site, the Joetsu Knoll, is a well - characterized location of methane seepage offshore the Joetsu City, Niigata Prefecture, Japan ( Figure 1; 3731. 1N, 13758. 0E, 985 mbsl).	methane seepage,72,87,state	"[{""token"": ""methane seepage"", ""start_span"": 72, ""end_span"": 87, ""type"": ""state""}]"	train
Chemical oxygen demand ( COD) analysis was performed using high - range COD digestion vials ( 2125915; Hach, Loveland, CO, USA) per standard methods ( 40).	COD,25,28,state	"[{""token"": ""COD"", ""start_span"": 25, ""end_span"": 28, ""type"": ""state""}]"	train
The presence of AHLs after the incubation period was detected by adding 50 L of a mixture of soft Agrobacterium ( AB) medium [ 61] ( 0. 2% agar) with 5 - bromo - 4 - chloro - 3 - indolyl - - D - galactopyroside ( X - GAL, 80 g / mL) and an overnight culture of A. tumefaciens NTL4 ( 1: 5) on top of the supernatants in microtiter wells.	AHLs,16,20,state	"[{""token"": ""AHLs"", ""start_span"": 16, ""end_span"": 20, ""type"": ""state""}]"	train
Two readers independently scored the radiographs according to the New York criteria, which describe five grades of sacroiliitis ranging from 0 to 4 ( 47).	sacroiliitis,115,127,state	"[{""token"": ""sacroiliitis"", ""start_span"": 115, ""end_span"": 127, ""type"": ""state""}]"	train
Notably, only 2 / 30 samples were from female participants.	female,39,45,state	"[{""token"": ""female"", ""start_span"": 39, ""end_span"": 45, ""type"": ""state""}]"	train
For the purpose of comparison with our experimental results, one post - eruption native basalt biofilm sample ( hereafter referred to as native Basalt) was collected from Tamtown ( 950. 3 N, 10417. 4 W: 2503 - m depth; 0. 58 km from Tica Vent: Figure 1), during the RESET06 cruise ( AT15 - 06, 2006 / 06 / 25 2006 / 07 / 01).	post - eruption,65,80,state	"[{""token"": ""post - eruption"", ""start_span"": 65, ""end_span"": 80, ""type"": ""state""}]"	train
They are heavily influenced by groundwater influx.	heavily influenced by groundwater influx,9,49,state	"[{""token"": ""heavily influenced by groundwater influx"", ""start_span"": 9, ""end_span"": 49, ""type"": ""state""}]"	train
The bioreactor was fed with anaerobic digester filtrate obtained from the belt filter press of a local wastewater treatment plant ( CVWRF, Salt Lake City, UT, USA).	anaerobic,28,37,state	"[{""token"": ""anaerobic"", ""start_span"": 28, ""end_span"": 37, ""type"": ""state""}]"	train
The concentrations of QMA were analyzed by an ion chromatograph DX - 120 ( Thermo Fisher, CA, USA).	QMA,22,25,state	"[{""token"": ""QMA"", ""start_span"": 22, ""end_span"": 25, ""type"": ""state""}]"	train
The digestate from the sequential batch bottles was used as inoculum, which has a dry matter ( DM) content of 3. 8%, the volatile solid ( VS) content of 2. 1%, and the pH of 7. 8.	sequential batch,23,39,state	"[{""token"": ""sequential batch"", ""start_span"": 23, ""end_span"": 39, ""type"": ""state""}]"	train
Materials and Methods Water Kefir Fermentation and Sampling The water kefir fermentation experiment that was initiated by water kefir grains received from a private individual from Lokeren, Belgium, and that was previously assessed as to its microbiology and metabolomics as described before ( Laureys and De Vuyst, 2017), was sampled for a metagenomic analysis in the present study.	fermentation,76,88,state	"[{""token"": ""fermentation"", ""start_span"": 76, ""end_span"": 88, ""type"": ""state""}]"	train
Pore - water samples for DIC were kept at 4C before analysis.	DIC,25,28,state	"[{""token"": ""DIC"", ""start_span"": 25, ""end_span"": 28, ""type"": ""state""}]"	train
The concentrations of available P was determined using the extraction - flame photometry with a 0. 5 M NaHCO3 extraction ( Emteryd, 1989).	available P,22,33,state	"[{""token"": ""available P"", ""start_span"": 22, ""end_span"": 33, ""type"": ""state""}]"	train
Materials and Methods Methods Overview Fluids were collected from six different hydraulically fractured natural - gas wells for geochemical and genomic analyses summarized in this manuscript: four natural - gas wells producing from the Utica - Pt.	hydraulically fractured,80,103,state	"[{""token"": ""hydraulically fractured"", ""start_span"": 80, ""end_span"": 103, ""type"": ""state""}]"	train
For the isolated strains showing wide - spectrum QQ activity, genomic DNA was extracted using a Wizard DNA purification Kit ( Promega, Madison, WI, USA), and the bacterial 16S rRNA gene was amplified using the universal primers 96 bfm ( 5 - GAGTTTGATYHTGGCTCAG - 3) and 1152 uR ( 5 - ACGGHTACCTTGTTACGACTT - 3) [ 59].	QQ,49,51,state	"[{""token"": ""QQ"", ""start_span"": 49, ""end_span"": 51, ""type"": ""state""}]"	train
A laboratory - scale SBR was used in this study.	laboratory - scale,2,20,state	"[{""token"": ""laboratory - scale"", ""start_span"": 2, ""end_span"": 20, ""type"": ""state""}]"	train
During the recovery process, on days 245 ( 8 June 2016), 250 ( 15 June 2016), 260 ( 25 June 2016), 275 ( 10 July 2016) and 285 ( 25 July 2016), five samples ( K16, L18, M20, N23 and M24) were collected, respectively.	recovery,11,19,state	"[{""token"": ""recovery"", ""start_span"": 11, ""end_span"": 19, ""type"": ""state""}]"	train
In addition, lower microbial diversity was found in the thermophilic reactors, especially for Bacteria, where a clear intensification towards Clostridia class members was evident.	thermophilic,56,68,state	"[{""token"": ""thermophilic"", ""start_span"": 56, ""end_span"": 68, ""type"": ""state""}]"	train
The uppermost and most turbid lakes ( FAS 1) is located close to the glacier terminus at 2. 620m a. s. l.	turbid,23,29,state	"[{""token"": ""turbid"", ""start_span"": 23, ""end_span"": 29, ""type"": ""state""}]"	train
Initial time - zero samples were taken before pasteurization and slurries were incubated for 2 weeks, with sub - sampling every 23 days.	before pasteurization,39,60,state	"[{""token"": ""before pasteurization"", ""start_span"": 39, ""end_span"": 60, ""type"": ""state""}]"	train
The bottles were flushed with nitrogen gas for a few minutes and sealed with septum and aluminum caps to maintain anaerobic conditions.	anaerobic conditions,114,134,state	"[{""token"": ""anaerobic conditions"", ""start_span"": 114, ""end_span"": 134, ""type"": ""state""}]"	train
To avoid excessive loss of microorganisms, the biomass was settled before purging by stopping the stirring for at least 2 h. Periodically the purged sludge was sampled for analysis; in that case the stirring was not stopped.	purged,142,148,state	"[{""token"": ""purged"", ""start_span"": 142, ""end_span"": 148, ""type"": ""state""}]"	train
In brief, sulfide deposits were collected from a depth of approximately 2 m below the seafloor at the Archaean site ( 1256. 3627N, 14337. 9036E, a water depth of 3, 024 m), which is another hydrothermal site in the SMT, using a seafloor coring system, and were then stored at 80C until DNA extraction.	hydrothermal,190,202,state	"[{""token"": ""hydrothermal"", ""start_span"": 190, ""end_span"": 202, ""type"": ""state""}]"	train
The headspace in each bottle was flushed with nitrogen gas, and sealed to achieve anaerobic conditions.	anaerobic conditions,82,102,state	"[{""token"": ""anaerobic conditions"", ""start_span"": 82, ""end_span"": 102, ""type"": ""state""}]"	train
We immediately dissected animals and collected contents of the foregut ( fornix ventricularis or fundus), acidic stomach, small intestine, cecum, and large intestine.	acidic stomach,106,120,state	"[{""token"": ""acidic stomach"", ""start_span"": 106, ""end_span"": 120, ""type"": ""state""}]"	train
Total bacterial RNA extraction and analysis of bacterial diversity Ninety milliliters of saline solution were added to 10 g of dough and homogenized for 5 min, and RNA was extracted from doughs produced in three different fermentation trials performed in different days ( Minervini et al., 2015).	fermentation,222,234,state	"[{""token"": ""fermentation"", ""start_span"": 222, ""end_span"": 234, ""type"": ""state""}]"	train
VFAs were measured by gas chromatography 890A ( Agilent Technologies, Santa Clara, CA) coupled with a Flame Ionization Detector ( FID) and J & W DB - WAX GC column ( Agilent Technologies, Santa Clara, CA).	VFAs,0,4,state	"[{""token"": ""VFAs"", ""start_span"": 0, ""end_span"": 4, ""type"": ""state""}]"	train
Sludge samples, UASB1a - UASB5a, from the full - scale UASB reactor were taken from the sampling ports located at heights of 30cm, 100cm, 200cm, 300cm, and 400cm ( Table 1).	full - scale,42,54,state	"[{""token"": ""full - scale"", ""start_span"": 42, ""end_span"": 54, ""type"": ""state""}]"	train
It is meromictic and therefore permanently anoxic below ca.	meromictic,6,16,state	"[{""token"": ""meromictic"", ""start_span"": 6, ""end_span"": 16, ""type"": ""state""}]"	train
Upon digester acclimation, which is defined by stable methane gas generation that was not significantly different across all four reactors, different amounts of tetracycline hydrochloric acid ( TC - HCl) were then added to each reactor.	methane,54,61,state	"[{""token"": ""methane"", ""start_span"": 54, ""end_span"": 61, ""type"": ""state""}]"	train
The bioreactor temperature was kept in the mesophilic range ( 3637. 5 C) with a water bath system ( Water bath, Ningbo Scientz Biotechnology Co., Ltd., Ningbo, China) connected to the bioreactor.	mesophilic,43,53,state	"[{""token"": ""mesophilic"", ""start_span"": 43, ""end_span"": 53, ""type"": ""state""}]"	train
The bottles had a headspace of N2 - CO2, were sealed with sterile butyl rubber stoppers and crimped with aluminum seals.	N2 - CO2,31,39,state	"[{""token"": ""N2 - CO2"", ""start_span"": 31, ""end_span"": 39, ""type"": ""state""}]"	train
Environmental parameter Nephelometric turbidity of composite water samples was measured using a portable instrument ( Turb 430T, WTW, Weilheim, Germany), which measures 90 scattered white ' light ( Tungsten lamp).	Nephelometric turbidity,24,47,state	"[{""token"": ""Nephelometric turbidity"", ""start_span"": 24, ""end_span"": 47, ""type"": ""state""}]"	train
Groups of three newly hatched chicks were inoculated with 107 CFU in 0. 1 ml of inoculum containing Parabacteroides johnsonii An42 ( phylum Bacteroidetes, GenBank access.	newly hatched,16,29,state	"[{""token"": ""newly hatched"", ""start_span"": 16, ""end_span"": 29, ""type"": ""state""}]"	train
After 20 days, exogenous SO42 ( 15 mM) was added to each microcosm to stimulate additional SO42 reduction.	SO42 reduction,91,105,state	"[{""token"": ""SO42 reduction"", ""start_span"": 91, ""end_span"": 105, ""type"": ""state""}]"	train
Sample collection, processing and RNA extraction The jejunum and ileum along with their contents were harvested from each carcass and processed as described previously [ 2].	carcass,122,129,state	"[{""token"": ""carcass"", ""start_span"": 122, ""end_span"": 129, ""type"": ""state""}]"	train
The contents of Cl, CO32 -, and HCO3 - were analyzed using titration methods ( Klute, 1986).	Cl,16,18,state	"[{""token"": ""Cl"", ""start_span"": 16, ""end_span"": 18, ""type"": ""state""}]"	train
Since the sequencing batch reactor ( SBR) operated with anaerobic / microaerobic cycles enriched for a less common clade of Ca.	anaerobic / microaerobic,56,80,state	"[{""token"": ""anaerobic / microaerobic"", ""start_span"": 56, ""end_span"": 80, ""type"": ""state""}]"	train
Reads and diversity indices obtained from the high - throughput analysis of archaeal and bacterial 16S rRNA gene amplicons for sludge samples taken from tetramethylammonium - degrading CMSS and UASB reactors.	tetramethylammonium - degrading,153,184,state	"[{""token"": ""tetramethylammonium - degrading"", ""start_span"": 153, ""end_span"": 184, ""type"": ""state""}]"	train
In the presence of one criterion, the segment was found to be mildly inflamed ( grade 1).	mildly inflamed,62,77,state	"[{""token"": ""mildly inflamed"", ""start_span"": 62, ""end_span"": 77, ""type"": ""state""}]"	train
None of the included subjects were vegetarians.	None of the included subjects were vegetarians,0,46,state	"[{""token"": ""None of the included subjects were vegetarians"", ""start_span"": 0, ""end_span"": 46, ""type"": ""state""}]"	train
Seasonlong CO2 exposure was carried out in cylindrical opentop chambers ( OTCs) 3. 2m in diameter and 3. 0m high ( Figure1) equipped with CO2 dispensing and monitoring systems ( Heagle, Philbeck, Rogers, & Letchworth, 1979; Weigel, Adaros, & Jger, 1987).	cylindrical,43,54,state	"[{""token"": ""cylindrical"", ""start_span"": 43, ""end_span"": 54, ""type"": ""state""}]"	train
16S rRNA community analysis of the non - enriched NP microbiome To determine the pre - enrichment NP bacterial community composition, 16S rRNA amplicon profiling was performed on the initial sample before the enrichment step.	non - enriched NP,35,52,state	"[{""token"": ""non - enriched NP"", ""start_span"": 35, ""end_span"": 52, ""type"": ""state""}]"	train
After arriving at our facilities, each mouse was given its own cage housed in a specific pathogen - free facility to avoid microbiome transfer62.	pathogen - free,89,104,state	"[{""token"": ""pathogen - free"", ""start_span"": 89, ""end_span"": 104, ""type"": ""state""}]"	train
To ensure the pH was around neutral throughout the incubation, Coleville synthetic brine medium ( CSBK) medium was used containing ( per 1 L): 1. 5 g NaCl, 0. 05 g KH2PO4, 0. 32 g NH4Cl, 0. 22 g CaCl2, 0. 54 g MgCl2 6H2O, and 0. 1 g KCl.	pH was around neutral,14,35,state	"[{""token"": ""pH was around neutral"", ""start_span"": 14, ""end_span"": 35, ""type"": ""state""}]"	train
DNA was extracted separately from each biomass sample to improve the recovery of MAGs and total RNA was extracted from the second biomass sample to examine steady - state community gene expression.	steady - state,156,170,state	"[{""token"": ""steady - state"", ""start_span"": 156, ""end_span"": 170, ""type"": ""state""}]"	train
Rainfall reduction is achieved by suspending the methacrylate troughs over an aluminum frame above the experimental plots ( height 130 cm, width 100 x 100 cm, Fig. S2).	Rainfall reduction,0,18,state	"[{""token"": ""Rainfall reduction"", ""start_span"": 0, ""end_span"": 18, ""type"": ""state""}]"	train
The larval gut epithelium has completely detached and floats freely in the lumen.	larval,4,10,state	"[{""token"": ""larval"", ""start_span"": 4, ""end_span"": 10, ""type"": ""state""}]"	train
To feature SMTZ in Core GC1, the sulphate - methane profile was inferred from that of Core ARA06C / 01JPC.	sulphate - methane,33,51,state	"[{""token"": ""sulphate - methane"", ""start_span"": 33, ""end_span"": 51, ""type"": ""state""}]"	train
Bacterial diversity and successional patterns during biofilm formation on freshly exposed basalt surfaces at diffuse - flow deep - sea vents Many deep - sea hydrothermal vent systems are regularly impacted by volcanic eruptions, leaving fresh basalt where abundant animal and microbial communities once thrived.	volcanic eruptions,209,227,state	"[{""token"": ""volcanic eruptions"", ""start_span"": 209, ""end_span"": 227, ""type"": ""state""}]"	train
Leaf gas exchange was measured on fully expanded leaves that were placed in a 2 cm2 leaf cuvette.	Leaf gas exchange,0,17,state	"[{""token"": ""Leaf gas exchange"", ""start_span"": 0, ""end_span"": 17, ""type"": ""state""}]"	train
Histopathological evaluation of colitis After careful dissection and fixation, tissues were embedded in paraffin.	colitis,32,39,state	"[{""token"": ""colitis"", ""start_span"": 32, ""end_span"": 39, ""type"": ""state""}]"	train
This measurement is tailored to measure turbidity caused by small inorganic particles.	turbidity,40,49,state	"[{""token"": ""turbidity"", ""start_span"": 40, ""end_span"": 49, ""type"": ""state""}]"	train
Determination of SCFA in Feces The analysis of short chain fatty acids ( SCFA) was carried out in a chromatographic system composed of two 6890N GC ( Agilent Technologies Inc., Palo Alto, CA, USA) connected to a FID and a MS 5973N detector as described previously [ 25].	SCFA,17,21,state	"[{""token"": ""SCFA"", ""start_span"": 17, ""end_span"": 21, ""type"": ""state""}]"	train
Additionally, scalp hairs were collected from adults residing in Virginia ( VA, n = 5).	adults,46,52,state	"[{""token"": ""adults"", ""start_span"": 46, ""end_span"": 52, ""type"": ""state""}]"	train
Cross sections ( 4 cm thick) of these chimneys top were realized aseptically; peripheral parts of the sections ( 2 cm thick) were cautiously removed using a chisel and sub - samples of the inside parts of the chimneys, bathed with the alkaline fluid, were collected and stored at 80C until DNA extraction, as detailed previously ( Qumneur et al., 2014; Postec et al., 2015).	alkaline,235,243,state	"[{""token"": ""alkaline"", ""start_span"": 235, ""end_span"": 243, ""type"": ""state""}]"	train
All of the inoculum sample preparation was performed in an anaerobic chamber ( Coy Laboratory Products, Grass Lake, MI, USA).	anaerobic,59,68,state	"[{""token"": ""anaerobic"", ""start_span"": 59, ""end_span"": 68, ""type"": ""state""}]"	train
The first one was frozen at - 20C for characterisation of microbial composition by sequencing over V3 / V4 variable regions of 16S rRNA genes and the second one was immediately used for oral inoculation of newly hatched chicks.	newly hatched,206,219,state	"[{""token"": ""newly hatched"", ""start_span"": 206, ""end_span"": 219, ""type"": ""state""}]"	train
Chicks in the control group were kept under the same conditions but without any contact with an adult hen.	without any contact with an adult hen,68,105,state	"[{""token"": ""without any contact with an adult hen"", ""start_span"": 68, ""end_span"": 105, ""type"": ""state""}]"	train
Subgingival plaque samples ( subgingival) were taken from the deepest periodontal pocket ( 4mm) of the sampling teeth.	plaque,12,18,state	"[{""token"": ""plaque"", ""start_span"": 12, ""end_span"": 18, ""type"": ""state""}]"	train
The collection was carried out monitoring the chromatogram at 280 nm up to 15 min, successively 350 nm was the wavelength selected to detect and recover the flavonoids.	flavonoids,157,167,state	"[{""token"": ""flavonoids"", ""start_span"": 157, ""end_span"": 167, ""type"": ""state""}]"	train
We explored the immunologic mechanisms behind this association using a mouse model of house dust mite ( HDM) - induced asthma and early - life ABX exposure.	early - life ABX exposure,130,155,state	"[{""token"": ""early - life ABX exposure"", ""start_span"": 130, ""end_span"": 155, ""type"": ""state""}]"	train
Mainly the transcriptome of lamina propria mononuclear cells ( LPMC) was affected by TSO treatment, showing dampened innate and adaptive inflammatory responses.	innate and adaptive inflammatory responses,117,159,state	"[{""token"": ""innate and adaptive inflammatory responses"", ""start_span"": 117, ""end_span"": 159, ""type"": ""state""}]"	train
Comparison to plastic debris from the North Atlantic Subtropical Gyre.	Subtropical Gyre,53,69,state	"[{""token"": ""Subtropical Gyre"", ""start_span"": 53, ""end_span"": 69, ""type"": ""state""}]"	train
After weaning, rats were housed in same sex sibling groups in rooms under humidity - ( 50 10%) and temperature ( 22 2C) controlled conditions, a 12 - h lightdark cycle ( lights on at 7 a. m.), and with food and water available ad libitum.	weaning,6,13,state	"[{""token"": ""weaning"", ""start_span"": 6, ""end_span"": 13, ""type"": ""state""}]"	train
Environmental 16S rRNA Gene - Defined Diversity Samples were thawed on ice and three 0. 5 g extractions were conducted using the CTAB method optimized for Antarctic oligotrophic environmental samples ( Archer et al., 2015).	oligotrophic,165,177,state	"[{""token"": ""oligotrophic"", ""start_span"": 165, ""end_span"": 177, ""type"": ""state""}]"	train
Potrero Grande watershed ( Figure 1) is characterized by a 10. 3 km long floodplain with very steep tributaries ( ~ 33% slope), such as Q. Danta.	very steep,89,99,state	"[{""token"": ""very steep"", ""start_span"": 89, ""end_span"": 99, ""type"": ""state""}]"	train
We here address the unknown diversity of animal phyla in marine environments using an extensive dataset designed to assess eukaryotic ribosomal diversity among European coastal locations.	marine,57,63,state	"[{""token"": ""marine"", ""start_span"": 57, ""end_span"": 63, ""type"": ""state""}]"	train
For intramuscular infection, mice were injected with ~ 20 L via insulin syringe ( 29 G needle) with undiluted virus into the medial aspect of the left hindlimb.	intramuscular infection,4,27,state	"[{""token"": ""intramuscular infection"", ""start_span"": 4, ""end_span"": 27, ""type"": ""state""}]"	train
Cohort description and sample collection Hair samples derived from scalp and pubic areas were collected from adults residing in Maryland ( MD, n = 8) and California ( CA, n = 8).	adults,109,115,state	"[{""token"": ""adults"", ""start_span"": 109, ""end_span"": 115, ""type"": ""state""}]"	train
As detailed parameters in a previous study [ 12], QMA ( 343mg / L) was fed as the sole substrate continuously with a stepwise decrement in hydraulic retention time ( HRT) to accommodate an increasing volumetric loading of 0. 6g C / L / d.	QMA,50,53,state	"[{""token"": ""QMA"", ""start_span"": 50, ""end_span"": 53, ""type"": ""state""}]"	train
To a second set of microcosms, additional toluene ( 71. 2570 mM) was added to 1 ml of oil phase in bottles that showed less than 5 mM reduction of nitrate after 90 days of incubation.	less than 5 mM reduction of nitrate,119,154,state	"[{""token"": ""less than 5 mM reduction of nitrate"", ""start_span"": 119, ""end_span"": 154, ""type"": ""state""}]"	train
Samples collected during the time course experiment at T11 and T25 consisted of water from the effluent outflow at the top of the HP - Core.	effluent outflow,95,111,state	"[{""token"": ""effluent outflow"", ""start_span"": 95, ""end_span"": 111, ""type"": ""state""}]"	train
These three drugs have been used in China for RA therapy for a long time with good effectiveness.	RA,46,48,state	"[{""token"": ""RA"", ""start_span"": 46, ""end_span"": 48, ""type"": ""state""}]"	train
Methods Biogas reactors configuration The experiment was carried out in a single and two - stage CSTRs, denoted as R1 and R2R3, respectively, as described by Fontana et al. [ 10].	single and two - stage,74,96,state	"[{""token"": ""single and two - stage"", ""start_span"": 74, ""end_span"": 96, ""type"": ""state""}]"	train
Mineralization of Organic Matters The mineralization rates were measured by two methods, ( 1) during both cruises, sulfate reduction rates ( SRRs) were determined the using the whole - core injection method ( Jrgensen, 1978).	sulfate reduction,115,132,state	"[{""token"": ""sulfate reduction"", ""start_span"": 115, ""end_span"": 132, ""type"": ""state""}]"	train
The average pollutant removal efficiency per month and influent characteristics for each of these WWTPs are summarized in Table1.	pollutant removal,12,29,state	"[{""token"": ""pollutant removal"", ""start_span"": 12, ""end_span"": 29, ""type"": ""state""}]"	train
13CH4 and 15N2 were injected at the start of the HP incubation experiment followed by periodic additions of 100% O2 on days 29, 30, 35, 37, 39, and 44 to stimulate aerobic methane - oxidation ( Figure 4).	aerobic methane - oxidation,164,191,state	"[{""token"": ""aerobic methane - oxidation"", ""start_span"": 164, ""end_span"": 191, ""type"": ""state""}]"	train
Grade 2: normal colorectal mucosal structure is replaced by a large number of neutrophils, fibroblasts and newly formed blood capillary vessels.	normal colorectal mucosal structure,9,44,state	"[{""token"": ""normal colorectal mucosal structure"", ""start_span"": 9, ""end_span"": 44, ""type"": ""state""}]"	train
Materials and Methods Field Sampling Sampling was conducted around the hyporheic zone of Spaulding Pond, Taylor Valley in the McMurdo Dry Valleys of Antarctica, during the austral summer of 2015.	Dry,134,137,state	"[{""token"": ""Dry"", ""start_span"": 134, ""end_span"": 137, ""type"": ""state""}]"	train
In short, produced fluid samples collected at 7 time points ( drilling mud sample prior to fracturing, days after fracturing 25, 34, 35, 79, 93, 142) from Marcellus Shale natural - gas well Marcellus - 4 ( 3001000 ml) were concentrated on a 0. 22 - m PES filter ( Nalgene; Fisher Scientific).	prior to fracturing,82,101,state	"[{""token"": ""prior to fracturing"", ""start_span"": 82, ""end_span"": 101, ""type"": ""state""}]"	train
These data constituted a subset of known serpentinizing systems, including four continental environments: Cabeo de Vide Aquifer ( Tiago and Verssimo, 2013), The Cedars ( Suzuki et al., 2013), Voltri ophiolite ( Qumneur et al., 2015), Leka ophiolite ( Daae et al., 2013), and one submarine system: the famous Lost - City Hydrothermal Field ( Schrenk et al., 2004; Brazelton et al., 2006).	serpentinizing,41,55,state	"[{""token"": ""serpentinizing"", ""start_span"": 41, ""end_span"": 55, ""type"": ""state""}]"	train
The Philippines had not implemented a national vaccination program against pneumococcus so half the children were randomly assigned to receive the PCV - 10 vaccine ( Rodenburg et al., 2010) vaccine.	children,100,108,state	"[{""token"": ""children"", ""start_span"": 100, ""end_span"": 108, ""type"": ""state""}]"	train
At the steady - state period, three samples ( C4, D5 and E8) were collected on days 140 ( 13 January 2016), 162 ( 23 March 2016) and 190 ( 20 April 2016), respectively.	steady - state,7,21,state	"[{""token"": ""steady - state"", ""start_span"": 7, ""end_span"": 21, ""type"": ""state""}]"	train
In addition, before study, all animals were treated with enrofloxacin ( 10mgkg1 once daily for 10 days), paromomycin ( 25mgkg1 twice daily for 10 days) and fenbendazole ( 50mgkg1 once daily for 5 days) followed by weekly faecal culture and parasite exams for 3 weeks to ensure they were free of common enteric pathogens.	free of common enteric pathogens,287,319,state	"[{""token"": ""free of common enteric pathogens"", ""start_span"": 287, ""end_span"": 319, ""type"": ""state""}]"	train
Lake ( 1 L) and snow melt ( 20 L) water were filtered through sterile Nalgene single - use filtration units ( pore size 0. 22 m) and filters were stored frozen.	frozen,153,159,state	"[{""token"": ""frozen"", ""start_span"": 153, ""end_span"": 159, ""type"": ""state""}]"	train
RNAi efficacy was monitored throughout the larval - pupal molt by performing relative qPCR on cDNA derived from dissected guts using the primers Gm _ Lys _ qPCR _ F1 ( 5 ' - ACTTTTACGAGATGCGGACTG - 3 ') and Gm _ Lys _ qPCR _ R1 ( 5 ' - TCTCATTCTCAACAAGGCACAC - 3 '), which target a region upstream of the region chosen as template for dsRNA synthesis, as well as S7e _ forward and S7e _ reverse which target the gene encoding ribosomal protein S7e [ 55], which was analyzed as a reference.	larval - pupal molt,43,62,state	"[{""token"": ""larval - pupal molt"", ""start_span"": 43, ""end_span"": 62, ""type"": ""state""}]"	train
The substrate, freeze dried Spirulina ( Sonnenmacht GmbH, Germany) and the alkaline medium, in g L1: Na2CO3, 95. 0; NaHCO3, 15. 0; NaCl, 16. 0 and K2HPO4, 1. 0; were the same for all three experiments.	alkaline,75,83,state	"[{""token"": ""alkaline"", ""start_span"": 75, ""end_span"": 83, ""type"": ""state""}]"	train
Initially, the 42 rats were randomly divided into two groups and fed either a normal chow diet ( NCD; n = 12) or a high - fat diet ( HFD; n = 30).	HFD,133,136,state	"[{""token"": ""HFD"", ""start_span"": 133, ""end_span"": 136, ""type"": ""state""}]"	train
EC7 had a comparable carbon monoxide ( CO) ppm to other EC users and controls.	EC users,56,64,state	"[{""token"": ""EC users"", ""start_span"": 56, ""end_span"": 64, ""type"": ""state""}]"	train
Incubations without antibiotics were also performed.	without antibiotics,12,31,state	"[{""token"": ""without antibiotics"", ""start_span"": 12, ""end_span"": 31, ""type"": ""state""}]"	train
Here we report the first catalog of microbial genes in fecal samples from Sprague - Dawley rats.	Sprague - Dawley,74,90,state	"[{""token"": ""Sprague - Dawley"", ""start_span"": 74, ""end_span"": 90, ""type"": ""state""}]"	train
Second, the diversity and abundance of predicted AR genes in the subjects fecal resistomes were analyzed and compared to the resistomes of 82 healthy persons reported by Kaminski et al. ( 2015) whose fecal samples were sequenced using a similar approach ( Human Microbiome Project Consortium, 2012).	healthy,142,149,state	"[{""token"": ""healthy"", ""start_span"": 142, ""end_span"": 149, ""type"": ""state""}]"	train
Stool sample collection and DNA extraction Stool samples were collected by the participants parents and stored in the household freezer ( 20C) until the next visit to the local study center; samples were then shipped on dry ice to the DIABIMMUNE Core Laboratory in Helsinki.	parents,92,99,state	"[{""token"": ""parents"", ""start_span"": 92, ""end_span"": 99, ""type"": ""state""}]"	train
Electron microscopy Paralyzed mice were perfused intracardially with ice - cold 0. 1 M phosphate buffer followed by Karnovskys fixative ( 2. 5% glutaraldehyde, 2% paraformaldehyde, in 0. 1 M phosphate buffer at pH 7. 4) until rigid.	Paralyzed,20,29,state	"[{""token"": ""Paralyzed"", ""start_span"": 20, ""end_span"": 29, ""type"": ""state""}]"	train
Age 1875years.	Age 1875years,0,13,state	"[{""token"": ""Age 1875years"", ""start_span"": 0, ""end_span"": 13, ""type"": ""state""}]"	train
The differences in cholesterols levels between the control and the treated groups were analyzed by Students t - test ( two - tailed) using GraphPad Prism version 6. 01 ( Graph Pad Software, San Diego, USA), and the significant differences were indicated as * P < 0. 05, * *	cholesterols,19,31,state	"[{""token"": ""cholesterols"", ""start_span"": 19, ""end_span"": 31, ""type"": ""state""}]"	train
Autistic subjects with clinically evident inflammatory conditions were excluded.	Autistic,0,8,state	"[{""token"": ""Autistic"", ""start_span"": 0, ""end_span"": 8, ""type"": ""state""}]"	train
These metagenome - assembled SAR202 genomes ( MAGs), together with the two SAGs provide a first insight into the metabolic capabilities of this group and suggest a significant role in the deep - ocean sulfur cycle.	sulfur,201,207,state	"[{""token"": ""sulfur"", ""start_span"": 201, ""end_span"": 207, ""type"": ""state""}]"	train
The Osterseen Lake District consists of a group of 19 small lakes located in the Bavarian pre - alpine region ca.	small,54,59,state	"[{""token"": ""small"", ""start_span"": 54, ""end_span"": 59, ""type"": ""state""}]"	train
Another two samples from the depths of 1000 m and 2000 m, were taken the next day ( October 16) in two casts ( 100 L each) using the CTD rosette.	2000 m,50,56,state	"[{""token"": ""2000 m"", ""start_span"": 50, ""end_span"": 56, ""type"": ""state""}]"	train
A control without bacteriophage inoculation was prepared for each temperature and pH condition.	without bacteriophage,10,31,state	"[{""token"": ""without bacteriophage"", ""start_span"": 10, ""end_span"": 31, ""type"": ""state""}]"	train
With regard to the microbiota composition and SCFA results were analyzed using SPSS software ( SPSS Inc., Chicago, IL, USA).	SCFA,46,50,state	"[{""token"": ""SCFA"", ""start_span"": 46, ""end_span"": 50, ""type"": ""state""}]"	train
For subjects who did not acquire MDRO, the last available rectal swab during the study period was analyzed.	did not acquire MDRO,17,37,state	"[{""token"": ""did not acquire MDRO"", ""start_span"": 17, ""end_span"": 37, ""type"": ""state""}]"	train
MATERIALS AND METHODS Operation of laboratory - scale sequencing batch reactor.	laboratory - scale,35,53,state	"[{""token"": ""laboratory - scale"", ""start_span"": 35, ""end_span"": 53, ""type"": ""state""}]"	train
An anaerobic environment was maintained using silicon rubber layers placed on both sides of the flow chambers, being pressed tightly together.	anaerobic,3,12,state	"[{""token"": ""anaerobic"", ""start_span"": 3, ""end_span"": 12, ""type"": ""state""}]"	train
Only the environmental parameters available for all stations were used; the bottom oxygen concentration was excluded because it can vary significantly in the different sediment layers.	oxygen concentration,83,103,state	"[{""token"": ""oxygen concentration"", ""start_span"": 83, ""end_span"": 103, ""type"": ""state""}]"	train
To explore how the relative abundance of taxa changed over time, we plotted proportional area plots of taxonomic composition for each woman by using taxa that represented at least 10% of at least one sample.	woman,134,139,state	"[{""token"": ""woman"", ""start_span"": 134, ""end_span"": 139, ""type"": ""state""}]"	train
The sampling campaign was designed to target baseflow conditions.	baseflow,45,53,state	"[{""token"": ""baseflow"", ""start_span"": 45, ""end_span"": 53, ""type"": ""state""}]"	train
Body weights were determined every 3 days ( Table S1).	Body weights,0,12,state	"[{""token"": ""Body weights"", ""start_span"": 0, ""end_span"": 12, ""type"": ""state""}]"	train
Ninety - eight subjects ( mean age, 37. 9 11. 9 years; 21 male and 77 female) provided signed informed consents prior to the procedure, and their details were omitted to ensure anonymity.	male,58,62,state	"[{""token"": ""male"", ""start_span"": 58, ""end_span"": 62, ""type"": ""state""}]"	train
The follow - up time was defined as the number of days from the baseline swab to the first swab positive for an MDRO.	positive for an MDRO,96,116,state	"[{""token"": ""positive for an MDRO"", ""start_span"": 96, ""end_span"": 116, ""type"": ""state""}]"	train
The five lakes in this group are all oligotrophic.	oligotrophic,37,49,state	"[{""token"": ""oligotrophic"", ""start_span"": 37, ""end_span"": 49, ""type"": ""state""}]"	train
The applied external resistance could vary between 6 and 200 via 2 steps ( R).	applied external resistance could vary between 6 and 200,4,60,state	"[{""token"": ""applied external resistance could vary between 6 and 200"", ""start_span"": 4, ""end_span"": 60, ""type"": ""state""}]"	train
Analysis of peroxidase activity Peroxidase activity in caecal lysates was measured as previously described25.	Peroxidase activity,32,51,state	"[{""token"": ""Peroxidase activity"", ""start_span"": 32, ""end_span"": 51, ""type"": ""state""}]"	train
Measurement of HIV - 1 load in CVL fluid and plasma.	HIV - 1 load,15,27,state	"[{""token"": ""HIV - 1 load"", ""start_span"": 15, ""end_span"": 27, ""type"": ""state""}]"	train
Samples from 46 children produced amplicons and were used in this study.	children,16,24,state	"[{""token"": ""children"", ""start_span"": 16, ""end_span"": 24, ""type"": ""state""}]"	train
As previously described [ 6] acute episodes of increased dyspnoea, sputum production and / or purulence appearing during follow - up and treated with antibiotics and / or oral corticosteroids were considered as exacerbations [ 18, 19].	exacerbations,211,224,state	"[{""token"": ""exacerbations"", ""start_span"": 211, ""end_span"": 224, ""type"": ""state""}]"	train
However, recently an unusual N2 - fixing unicellular cyanobacteria ( UCYN - A) / haptophyte symbiosis was reported with a broader temperature range than other N2 - fixing cyanobacteria.	broader temperature range,122,147,state	"[{""token"": ""broader temperature range"", ""start_span"": 122, ""end_span"": 147, ""type"": ""state""}]"	train
2 - Bromoethanesulfonate ( BES) was added to prevent methanogen growth only during start - up.	start - up,83,93,state	"[{""token"": ""start - up"", ""start_span"": 83, ""end_span"": 93, ""type"": ""state""}]"	train
The gas absorber and the bioreactor temperature were regulated at 35 C by a thermostat bath ( DC10, Thermo Haake, Germany).	35 C,66,70,state	"[{""token"": ""35 C"", ""start_span"": 66, ""end_span"": 70, ""type"": ""state""}]"	train
Gillson Park is located north of Chicago in Wilmette, IL; this beach is recreational and adjacent to the north of Wilmette Harbor.	recreational,72,84,state	"[{""token"": ""recreational"", ""start_span"": 72, ""end_span"": 84, ""type"": ""state""}]"	train
Lakes Stechsee, Grbensee, Gartensee, and Ursee form part of the main chain and are characterized by a brownish water color due to wash out of humic substances from the peat.	brownish water color,102,122,state	"[{""token"": ""brownish water color"", ""start_span"": 102, ""end_span"": 122, ""type"": ""state""}]"	train
We did not find a significant difference in food intake between the control ( 463g / mouse / week) and KD mice ( 472g / mouse / week; p > 0. 5).	food intake,44,55,state	"[{""token"": ""food intake"", ""start_span"": 44, ""end_span"": 55, ""type"": ""state""}]"	train
Sediment aliquots were subsequently diluted in a 1: 2 ( w / w) ratio with anoxic, artificial seawater medium [ 43] containing 20mM sulfate under a constant flow of N2: CO2.	anoxic,74,80,state	"[{""token"": ""anoxic"", ""start_span"": 74, ""end_span"": 80, ""type"": ""state""}]"	train
Non - bioaugmented bottles fed with untreated birch ( untreated + 0%) were also prepared to compare the process performance with bottles fed with steam - exploded birch.	Non - bioaugmented,0,18,state	"[{""token"": ""Non - bioaugmented"", ""start_span"": 0, ""end_span"": 18, ""type"": ""state""}]"	train
To reveal important causes and effects of this variation, we performed an extensive chemical and microbiological characterization of a low - temperature venting area in the Loki ' s Castle Vent Field ( LCVF).	low - temperature,135,152,state	"[{""token"": ""low - temperature"", ""start_span"": 135, ""end_span"": 152, ""type"": ""state""}]"	train
The COD removal was stable from the first day of operation, above 95, 90 and 80% in R1, R2 and R3 respectively.	COD,4,7,state	"[{""token"": ""COD"", ""start_span"": 4, ""end_span"": 7, ""type"": ""state""}]"	train
Nine hundred milliliters of synthetic wastewater ( Nopens et al. 2001) containing 690mg / L COD was added to the sludge to achieve approximately 1. 5 to 1. 6g / L of mixed liquor volatile suspended solids ( MLVSS) in each bottle ( total digester volume of 1L).	690mg / L COD,82,95,state	"[{""token"": ""690mg / L COD"", ""start_span"": 82, ""end_span"": 95, ""type"": ""state""}]"	train
The influent mainly contained QMA with the concentrations of 455 ~ 1100mg / L, which was equivalent to ~ 85% of total organic carbon and 98% of total organic nitrogen in wastewater.	QMA,30,33,state	"[{""token"": ""QMA"", ""start_span"": 30, ""end_span"": 33, ""type"": ""state""}]"	train
Seawater temperature around the area ranges from 6 to 9C.	6 to 9C,49,56,state	"[{""token"": ""6 to 9C"", ""start_span"": 49, ""end_span"": 56, ""type"": ""state""}]"	train
Sludge inoculum of 100mL each was added to four 1. 2L dark glass bottles.	dark,54,58,state	"[{""token"": ""dark"", ""start_span"": 54, ""end_span"": 58, ""type"": ""state""}]"	train
The batch anaerobic digestion was performed in 309mL serum bottles, to which substrate was added corresponding to 3g volatile solids ( VS) per liter, and the inoculum: substrate ratio was between 2: 1 and 4: 1.	batch anaerobic digestion,4,29,state	"[{""token"": ""batch anaerobic digestion"", ""start_span"": 4, ""end_span"": 29, ""type"": ""state""}]"	train
This study used metagenomics sequencing to survey the microbiota of the Amazon Basin lakes during flood season, showing important patterns in microbial communities.	flood,98,103,state	"[{""token"": ""flood"", ""start_span"": 98, ""end_span"": 103, ""type"": ""state""}]"	train
MATERIALS AND METHODS Samples and biogas reactor operational data.	biogas,34,40,state	"[{""token"": ""biogas"", ""start_span"": 34, ""end_span"": 40, ""type"": ""state""}]"	train
Insect rearing G. mellonella larvae were reared in the dark at 30C on a grain - honey diet described previously [ 29].	larvae,29,35,state	"[{""token"": ""larvae"", ""start_span"": 29, ""end_span"": 35, ""type"": ""state""}]"	train
This was achieved by chick inoculation with Aviguard, commercially available competitive exclusion product containing the normal gut microbiota from specific pathogen - free chickens ( Lallemand, France) or by bacterial washes from WCHA ( Wilkins - Chalgren Agar) and YCFA ( Yeast extract, Casitone and Fatty Acid agar) agars obtained by anaerobic culture of serially diluted caecal samples from an adult hen.	adult,399,404,state	"[{""token"": ""adult"", ""start_span"": 399, ""end_span"": 404, ""type"": ""state""}]"	train
Carbon and nitrogen fixation rates Carbon ( C) and dinitrogen ( N2) fixation rates were measured using the 13C method of Legendre and Gosselin ( 1997) and a modification of the 15N2 uptake method of Montoya et al. ( 1996) to avoid delayed bubble dissolution ( Mohr et al., 2010; Wilson et al., 2012).	Carbon and nitrogen fixation,0,28,state	"[{""token"": ""Carbon and nitrogen fixation"", ""start_span"": 0, ""end_span"": 28, ""type"": ""state""}]"	train
A gene catalogue of the Sprague - Dawley rat gut metagenome Abstract Background Laboratory rats such as the Sprague - Dawley ( SD) rats are an important model for biomedical studies in relation to human physiological or pathogenic processes.	Sprague - Dawley,24,40,state	"[{""token"": ""Sprague - Dawley"", ""start_span"": 24, ""end_span"": 40, ""type"": ""state""}]"	train
Incubations without antibiotics were successively transferred ( 10% ( v / v)) to new bicarbonatebuffered medium and fed with CO for 2years with 40% CO, resulting in an enrichment series designated as CO ( x) ( where x stands for number of successive transfers).	without antibiotics,12,31,state	"[{""token"": ""without antibiotics"", ""start_span"": 12, ""end_span"": 31, ""type"": ""state""}]"	train
The Coulombic efficiency was estimated based on the complete oxidation from thiocyanate to sulfate, according to Eq. 6, where [ SCN] was the decrease of thiocyanate in mol; F is the faraday constant ( 96485 C / mol); and electrical current ( I) was expressed in A. The experiment was carried out in a temperature - controlled room maintained at 8C.	8C,345,347,state	"[{""token"": ""8C"", ""start_span"": 345, ""end_span"": 347, ""type"": ""state""}]"	train
Grade 0: normal colorectal mucosa.	normal colorectal mucosa,9,33,state	"[{""token"": ""normal colorectal mucosa"", ""start_span"": 9, ""end_span"": 33, ""type"": ""state""}]"	train
Aliquots ( 10 g) of the C and C - IF doughs were collected after the first fermentation, stored ( at 80C) in 10 ml of RNAlater diluted ( 1: 1) with water, and analyzed by culture - independent method ( 16S metagenetics).	fermentation,75,87,state	"[{""token"": ""fermentation"", ""start_span"": 75, ""end_span"": 87, ""type"": ""state""}]"	train
A negative control microcosm for each sediment sample did not receive additional DOC.	did not receive additional DOC,54,84,state	"[{""token"": ""did not receive additional DOC"", ""start_span"": 54, ""end_span"": 84, ""type"": ""state""}]"	train
Initially, all reactors were inoculated with thermophilic inoculum obtained from Snertinge biogas plant, Denmark.	biogas,91,97,state	"[{""token"": ""biogas"", ""start_span"": 91, ""end_span"": 97, ""type"": ""state""}]"	train
The synthetic wastewater was dispensed as two separate media; medium A contained the acetate and phosphate, whereas medium B supplied the ammonia ( 8).	acetate,85,92,state	"[{""token"": ""acetate"", ""start_span"": 85, ""end_span"": 92, ""type"": ""state""}]"	train
Metagenomic Samples Eight samples ( Med - OCT2015 - 15 m, Med - OCT2015 - 30 m, Med - OCT2015 - 45 m, Med - OCT2015 - 60 m, Med - OCT2015 - 75 m, Med - OCT2015 - 90 m, Med - OCT2015 - 1000 m, and Med - OCT2015 - 2000 m) [ 55, 56] from different depths were taken for metagenomic analyses on October 15, 2015 at a single sampling site in the Western Mediterranean ( 37. 35361 N, 0. 286194 W).	2000 m,212,218,state	"[{""token"": ""2000 m"", ""start_span"": 212, ""end_span"": 218, ""type"": ""state""}]"	train
After each fermentation, sourdoughs were stored at 4C for ca.	fermentation,11,23,state	"[{""token"": ""fermentation"", ""start_span"": 11, ""end_span"": 23, ""type"": ""state""}]"	train
Calprotectin values < 50g / g per stool sample were considered normal.	Calprotectin values < 50g / g,0,29,state	"[{""token"": ""Calprotectin values < 50g / g"", ""start_span"": 0, ""end_span"": 29, ""type"": ""state""}]"	train
They were on average 510 cm in diameter.	510 cm in diameter,21,39,state	"[{""token"": ""510 cm in diameter"", ""start_span"": 21, ""end_span"": 39, ""type"": ""state""}]"	train
Samples from 90 and 2000 m depth were also used for bacterial isolation and functional screening.	2000 m,20,26,state	"[{""token"": ""2000 m"", ""start_span"": 20, ""end_span"": 26, ""type"": ""state""}]"	train
If two criteria were fulfilled, we diagnosed the segment as moderately inflamed ( grade 2).	moderately inflamed,60,79,state	"[{""token"": ""moderately inflamed"", ""start_span"": 60, ""end_span"": 79, ""type"": ""state""}]"	train
Animals utilized in this study were not treated with antibiotics at any point during the course of the study.	not treated with antibiotics,36,64,state	"[{""token"": ""not treated with antibiotics"", ""start_span"": 36, ""end_span"": 64, ""type"": ""state""}]"	train
Therefore, we performed metagenomics high - throughput sequencing to understand the ecology of microbial communities from the lakes throughout the flood season.	flood,147,152,state	"[{""token"": ""flood"", ""start_span"": 147, ""end_span"": 152, ""type"": ""state""}]"	train
This approach ensured the same depth range was obtained for all samples which bracketed the ground surface and the anaerobicaerobic interface.	anaerobicaerobic,115,131,state	"[{""token"": ""anaerobicaerobic"", ""start_span"": 115, ""end_span"": 131, ""type"": ""state""}]"	train
Briefly, four active carbonate chimneys were sampled at four distinct sites of the Bay of Prony, including the Bain des Japonais ( BdJ), the sites ( ST) ST07 ( also called Aiguille de Prony), ST09 and ST12.	active carbonate,14,30,state	"[{""token"": ""active carbonate"", ""start_span"": 14, ""end_span"": 30, ""type"": ""state""}]"	train
After 10 h of phage infection, biofilm was sonicated in 3. 5 mL of 1 PBS and analyzed based on procedures as described in sections P. aeruginosa Colony and Bacteriophage Plaque Counts on Membranes and RNA Extraction and 16S rRNA Gene Based High - Throughput Sequencing.	Bacteriophage Plaque,156,176,state	"[{""token"": ""Bacteriophage Plaque"", ""start_span"": 156, ""end_span"": 176, ""type"": ""state""}]"	train
The hyperalkaline system ( Q. Danta) within Potrero Grande is located in the headwaters about 121 m a. s. l.	hyperalkaline,4,17,state	"[{""token"": ""hyperalkaline"", ""start_span"": 4, ""end_span"": 17, ""type"": ""state""}]"	train
Antibiotic ( ABX) Treatment The ABX treatment schedule was adapted from Nobel et al ( 16).	ABX treatment,32,45,state	"[{""token"": ""ABX treatment"", ""start_span"": 32, ""end_span"": 45, ""type"": ""state""}]"	train
Materials and methods Sampling of marine sediments Marine surface sediments ( 020cm below seafloor) were collected from 111 locations in the Eastern Gulf of Mexico ( Fig. 1; Supplementary TableS1) during JanuaryMarch, 2011, aboard RV GeoExplorer as part of TDI Brooks Internationals Surface Geochemical Exploration ( SGE) program.	Marine,51,57,state	"[{""token"": ""Marine"", ""start_span"": 51, ""end_span"": 57, ""type"": ""state""}]"	train
Materials and methods MEC reactors and operation Mini - MECs were prepared as described by Call and Logan ( 2011) using 5 mL clear glass serum bottles ( Wheaton, Millville, NJ, USA).	Mini,49,53,state	"[{""token"": ""Mini"", ""start_span"": 49, ""end_span"": 53, ""type"": ""state""}]"	train
Metals associated with river sediments collected downstream of the Gold King Mine in August 2015 exhibited distinct presence and abundance patterns linked to location and mineralogy.	Metals,0,6,state	"[{""token"": ""Metals"", ""start_span"": 0, ""end_span"": 6, ""type"": ""state""}]"	train
Materials and Methods Metagenomic Sampling and DNA Extraction All samples were obtained from shallow groundwater located at the Integrated Field Research Center ( OR - IFRC) at the Y - 12 Federal Security Complex in Oak Ridge, TN.	shallow,93,100,state	"[{""token"": ""shallow"", ""start_span"": 93, ""end_span"": 100, ""type"": ""state""}]"	train
The founding animals of this M. musculus colony were collected from near Gainesville, Florida, USA.	colony,41,47,state	"[{""token"": ""colony"", ""start_span"": 41, ""end_span"": 47, ""type"": ""state""}]"	train
Within the Horonobe URL, three main shafts provide access to subsurface galleries, where boreholes have been drilled into the rock faces.	rock faces,126,136,state	"[{""token"": ""rock faces"", ""start_span"": 126, ""end_span"": 136, ""type"": ""state""}]"	train
Deeper intervals for thermogenic hydrocarbon analyses were also frozen at 20C.	thermogenic hydrocarbon,21,44,state	"[{""token"": ""thermogenic hydrocarbon"", ""start_span"": 21, ""end_span"": 44, ""type"": ""state""}]"	train
The headspace of the microcosms was vacuumed and purged with N2 five times to ensure anaerobic conditions.	anaerobic conditions,85,105,state	"[{""token"": ""anaerobic conditions"", ""start_span"": 85, ""end_span"": 105, ""type"": ""state""}]"	train
Colonization of germ - free mice - A 80C stock plate of the clonally - arrayed culture collection was thawed in the anaerobic chamber.	germ - free,16,27,state	"[{""token"": ""germ - free"", ""start_span"": 16, ""end_span"": 27, ""type"": ""state""}]"	train
The prebiotic activity was evaluated using Lisosan G, LG1 batch, at 0. 5% and 1% ( w / v) in m - MRS.	prebiotic activity,4,22,state	"[{""token"": ""prebiotic activity"", ""start_span"": 4, ""end_span"": 22, ""type"": ""state""}]"	train
The two MFCs operated under the same hydraulic conditions and differed only in the electrical load application ( Fig 1).	hydraulic conditions,37,57,state	"[{""token"": ""hydraulic conditions"", ""start_span"": 37, ""end_span"": 57, ""type"": ""state""}]"	train
Animals were fasted overnight prior to TSO administration and sedated with 0. 4ml Hypnorm ( VetaPharma, Leeds, UK), s. c.	fasted,13,19,state	"[{""token"": ""fasted"", ""start_span"": 13, ""end_span"": 19, ""type"": ""state""}]"	train
Samples from the three lakes were collected in the morning ( 9: 00 a. m. to 12: 00p. m.) in March 2015 ( flood season) from Lake Baixio ( 03174. 69S, 600324. 419W, at a depth of 1m below the surface), Manacapuru Great Lake ( 03191. 38S, 604753W, at a depth of 2m below the surface), and Lake Preto ( 032121. 76S, 603736. 76W, at a depth of 1m below the surface).	flood,105,110,state	"[{""token"": ""flood"", ""start_span"": 105, ""end_span"": 110, ""type"": ""state""}]"	train
HIV - 1 clinical viral load testing in plasma was performed by the Global Clinical Viral Laboratory, South Africa, as previously described ( 18).	HIV - 1 clinical viral load,0,27,state	"[{""token"": ""HIV - 1 clinical viral load"", ""start_span"": 0, ""end_span"": 27, ""type"": ""state""}]"	train
Additional research focusing on the microbial community compositions of these full - scale installations was based on 16S rRNA gene amplicon sequencing ( Kiragosyan et al. 2019).	full - scale,78,90,state	"[{""token"": ""full - scale"", ""start_span"": 78, ""end_span"": 90, ""type"": ""state""}]"	train
The medium was prepared in lots of 1. 0 L, its pH was adjusted to 10. 0 at 35C, and was stored at 37C until use.	35C,75,78,state	"[{""token"": ""35C"", ""start_span"": 75, ""end_span"": 78, ""type"": ""state""}]"	train
Experimental procedures Substrate and reactors performances Dairy cattle manure was obtained from Research Centre Foulum ( Aarhus University, Denmark) in two periods ( April and June).	Dairy,60,65,state	"[{""token"": ""Dairy"", ""start_span"": 60, ""end_span"": 65, ""type"": ""state""}]"	train
Basalt panels were deployed either at a diffuse - flow vent site ( Experiment site 1: 15C) or a nearby, non - vent site ( Control site: 1. 8C).	15C,86,89,state	"[{""token"": ""15C"", ""start_span"": 86, ""end_span"": 89, ""type"": ""state""}]"	train
The BdJ site is located on the foreshore of the Carenage Bay and is uncovered at low tide.	low tide,81,89,state	"[{""token"": ""low tide"", ""start_span"": 81, ""end_span"": 89, ""type"": ""state""}]"	train
Process networks ( PN, groups of genes involved in main signalling and metabolic processes in the cell in the MetaCore database) were considered significant with a p - Value0. 05 and were listed on the basis of their relevance to IBD pathology.	IBD,230,233,state	"[{""token"": ""IBD"", ""start_span"": 230, ""end_span"": 233, ""type"": ""state""}]"	train
In addition, high - density lipoprotein ( HDL) levels were significantly lower ( P < 0. 05) in HFD - fed rats compared to NCD controls ( Fig. 1D).	HFD,95,98,state	"[{""token"": ""HFD"", ""start_span"": 95, ""end_span"": 98, ""type"": ""state""}]"	train
Chemical Measurements For additional habitat characterization, we attached a time - series temperature sensor ( VEMCO) directly to one of the basalt panels at both the experimental ( attached to Day 293E) and control sites ( attached to Day 13C; Supplementary Figure S2) and deployed an in situ chemical sensor at Experiment site 1, to monitor dissolved H2S, Eh ( oxidation - reduction potential), and temperature ( Supplementary Figures S3AC).	dissolved H2S,344,357,state	"[{""token"": ""dissolved H2S"", ""start_span"": 344, ""end_span"": 357, ""type"": ""state""}]"	train
Six biomass samples from within a reactor cycle on operational day 522 ( Fig. 1) were collected and immediately processed to determine transcript abundance.	within a reactor cycle,25,47,state	"[{""token"": ""within a reactor cycle"", ""start_span"": 25, ""end_span"": 47, ""type"": ""state""}]"	train
Incubations were done aseptically and under strict anaerobic conditions, as described elsewhere ( 6).	anaerobic conditions,51,71,state	"[{""token"": ""anaerobic conditions"", ""start_span"": 51, ""end_span"": 71, ""type"": ""state""}]"	train
At each location, bulk surface soil ( top 50 mm) was recovered directly from a sandy currently dry wash directly into sterile 50 mL centrifuge tubes ( n = 9, although three samples failed post - sequencing quality control and were excluded from further analysis, thus final n = 6).	sandy,79,84,state	"[{""token"": ""sandy"", ""start_span"": 79, ""end_span"": 84, ""type"": ""state""}]"	train
Pilot studies demonstrated that this dilution range is sufficient to produce only partial HIV - 1 inactivation in most CVF samples.	partial HIV - 1 inactivation,82,110,state	"[{""token"": ""partial HIV - 1 inactivation"", ""start_span"": 82, ""end_span"": 110, ""type"": ""state""}]"	train
Cores were taken from the top 10 cm of the soil profile in areas generally void of vegetation.	void of vegetation,75,93,state	"[{""token"": ""void of vegetation"", ""start_span"": 75, ""end_span"": 93, ""type"": ""state""}]"	train
Hydrothermarchaeota recovered from hydrothermally - inactive metal sulfide deposits at the Southern Mariana Trough ( SMT) in the north - west Pacific.	hydrothermally - inactive,35,60,state	"[{""token"": ""hydrothermally - inactive"", ""start_span"": 35, ""end_span"": 60, ""type"": ""state""}]"	train
PCR Amplification, Clone Library Construction, and Phylogenetic Analysis of Archaeal 16S rRNA Genes The archaeal communities obtained from various heights ( UASB1a - UASB5a) in a methanogenic bioreactor were investigated by denaturing gradient gel electrophoresis - ( DGGE -) cloning approaches through amplification of the 16S rRNA by using the primers Arc344f - mod and Arch958r - mod [ 16].	methanogenic,179,191,state	"[{""token"": ""methanogenic"", ""start_span"": 179, ""end_span"": 191, ""type"": ""state""}]"	train
DNA extraction Samples for microbial community analysis were taken from the inoculum on the start day of the BMP test and at the end of the anaerobic batch test.	start day of the BMP test,92,117,state	"[{""token"": ""start day of the BMP test"", ""start_span"": 92, ""end_span"": 117, ""type"": ""state""}]"	train
Based on their nutrient load they are classed as meso - oligotrophic.	meso - oligotrophic,49,68,state	"[{""token"": ""meso - oligotrophic"", ""start_span"": 49, ""end_span"": 68, ""type"": ""state""}]"	train
There was an air pocket between the sediment and ice layer.	air pocket between the sediment and ice layer,13,58,state	"[{""token"": ""air pocket between the sediment and ice layer"", ""start_span"": 13, ""end_span"": 58, ""type"": ""state""}]"	train
Presence of VFA was also measured for each of the reactors.	VFA,12,15,state	"[{""token"": ""VFA"", ""start_span"": 12, ""end_span"": 15, ""type"": ""state""}]"	train
Materials and Methods Experimental set - up and inoculation Two replicate, dual - chamber MFCs were constructed and operated to remove organic matter from swine manure with bioelectricity production.	dual - chamber,75,89,state	"[{""token"": ""dual - chamber"", ""start_span"": 75, ""end_span"": 89, ""type"": ""state""}]"	train
DNA extraction and purification DNA was isolated from anaerobic digester samples using a modified bead beating protocol.	anaerobic,54,63,state	"[{""token"": ""anaerobic"", ""start_span"": 54, ""end_span"": 63, ""type"": ""state""}]"	train
Pediatric samples were collected in accordance with induced sputum protocols [ 14], and adult samples were spontaneously produced as described by Gifford et al. [ 13].	adult,88,93,state	"[{""token"": ""adult"", ""start_span"": 88, ""end_span"": 93, ""type"": ""state""}]"	train
cDNA from doughs produced in three fermentation trials was pooled, dried using a vacuum centrifuge ( SpeedVac Concentrator SPD121P, Thermo Scientific) and used as template for 16S metagenetics, which were carried out at the Research and Testing Laboratory ( 2016) ( RTL, Lubbock, TX), by using the Illumina MiSeq platform.	fermentation,35,47,state	"[{""token"": ""fermentation"", ""start_span"": 35, ""end_span"": 47, ""type"": ""state""}]"	train
Samples were collected from the start of flowback at various intervals over a year into production ( 496 days) as previously reported ( Luek et al., 2018).	from the start of flowback,23,49,state	"[{""token"": ""from the start of flowback"", ""start_span"": 23, ""end_span"": 49, ""type"": ""state""}]"	train
During daily sampling, pressure was kept at 10 MPa by injection of sterile artificial seawater that contained no carbon sources ( see Supplementary Text).	pressure was kept at 10 MPa,23,50,state	"[{""token"": ""pressure was kept at 10 MPa"", ""start_span"": 23, ""end_span"": 50, ""type"": ""state""}]"	train
Goblet cells in some of the crypts were lost; the architecture of the GI tract was mostly preserved.	Goblet cells in some of the crypts were lost,0,44,state	"[{""token"": ""Goblet cells in some of the crypts were lost"", ""start_span"": 0, ""end_span"": 44, ""type"": ""state""}]"	train
DNA and RNA sequencing Two independent biomass samples were collected from the anammox bioreactor at different time points during periods of high total nitrogen removal efficiency ( > 80%).	anammox,79,86,state	"[{""token"": ""anammox"", ""start_span"": 79, ""end_span"": 86, ""type"": ""state""}]"	train
For the comparison between the H. pylori - infected and non - infected subjects, > 1% H. pylori relative abundance was defined as H. pylori infection [ 24].	non - infected,56,70,state	"[{""token"": ""non - infected"", ""start_span"": 56, ""end_span"": 70, ""type"": ""state""}]"	train
The dilution rate is a crucial process parameter for continuous stirred tank reactors ( CSTR), which is one of the most prevalent reactor configurations for AD around the world, and particularly in Germany ( Weiland, 2010).	AD,157,159,state	"[{""token"": ""AD"", ""start_span"": 157, ""end_span"": 159, ""type"": ""state""}]"	train
Due to the limited volumes of PW fluids collected during the sampling trip, only one live replicate was prepared per oil type so as to ensure that adequate sterile ( autoclaved) replicates ( one for each oil type) and an oil - free control ( incubated for 21 months) could also be established.	oil - free,221,231,state	"[{""token"": ""oil - free"", ""start_span"": 221, ""end_span"": 231, ""type"": ""state""}]"	train
Brackish datasets include two aphotic depths of the Caspian Sea.	Brackish,0,8,state	"[{""token"": ""Brackish"", ""start_span"": 0, ""end_span"": 8, ""type"": ""state""}]"	train
Three representative deep, marine metagenomes from the MALASPINA expedition were also used for assembly ( SRR3965592, SRR3963457, and SRR3961935).	marine,27,33,state	"[{""token"": ""marine"", ""start_span"": 27, ""end_span"": 33, ""type"": ""state""}]"	train
Sequential Mn Extractions and ICP - MS Measurements Manganese ( II) was determined in two different fractions as described by Tessier et al. ( 1979) with slight modification.	Mn,11,13,state	"[{""token"": ""Mn"", ""start_span"": 11, ""end_span"": 13, ""type"": ""state""}]"	train
Patients received either a zincsubstituted carbonated hydroxyapatite dentifrice ( HA group, BioRepair, Wolff, Bielefeld, Germany) or a dentifrice containing an amine fluoride / stannous fluoride ( AmF / SnF2 group, Meridol, CP GABA, Hamburg, Germany) with no further oral hygiene instructions.	Patients,0,8,state	"[{""token"": ""Patients"", ""start_span"": 0, ""end_span"": 8, ""type"": ""state""}]"	train
Complete ammonium removal was achieved after 3, 4 and 6weeks in R1, R2 and R3 respectively ( Additional file 1: Figure S3).	ammonium,9,17,state	"[{""token"": ""ammonium"", ""start_span"": 9, ""end_span"": 17, ""type"": ""state""}]"	train
24 - hour dietary recalls were conducted using a multiple pass system ( Tippett et al., 1999) with food models and measuring cups and spoons for portion size estimations.	dietary recalls,10,25,state	"[{""token"": ""dietary recalls"", ""start_span"": 10, ""end_span"": 25, ""type"": ""state""}]"	train
Moreover, bioaugmentation with the cellulolytic bacterium Caldicellulosiruptor bescii was applied to possibly enhance the methane production from steam - exploded birch in an anaerobic digestion ( AD) process under thermophilic conditions ( 62C).	methane,122,129,state	"[{""token"": ""methane"", ""start_span"": 122, ""end_span"": 129, ""type"": ""state""}]"	train
Immunosuppression Immunosuppressive treatment was started 2 weeks prior to the first TSO gavage.	Immunosuppression,0,17,state	"[{""token"": ""Immunosuppression"", ""start_span"": 0, ""end_span"": 17, ""type"": ""state""}]"	train
In addition, serial dilutions of irradiated flour ( IF) were maintained in a water bath at 80C for 15 min to activate spores, plated in Plate Count agar and incubated at 30C ( under aerobic or anaerobic conditions) for up to 76 h ( Aziz et al., 2006).	30C,170,173,state	"[{""token"": ""30C"", ""start_span"": 170, ""end_span"": 173, ""type"": ""state""}]"	train
Results Viral load in nasopharyngeal aspirates of patients associates significantly to total nasopharyngeal microbiota composition.	patients,50,58,state	"[{""token"": ""patients"", ""start_span"": 50, ""end_span"": 58, ""type"": ""state""}]"	train
( 40) 6654438. 717. 96. 1Sediment ( 386) 33118. 821. 8 From the V4 total cleaned BioMarKs protist datasets for two templates, rDNA and rRNA, the dissolved rDNA samples, duplicates and samples from anoxic sediment from Varna were removed and the metabarcodes ( or unique ribotypes) assigned to Bacillariophyta were extracted.	anoxic,197,203,state	"[{""token"": ""anoxic"", ""start_span"": 197, ""end_span"": 203, ""type"": ""state""}]"	train
Materials and methods Study site and sampling The Faselfad lakes are situated in the Austrian Central Alps and originated from a single, rapidly retreating glacier, which is located on a steep slope ( for overview maps and photographs, see Supplementary Material 1).	rapidly retreating,137,155,state	"[{""token"": ""rapidly retreating"", ""start_span"": 137, ""end_span"": 155, ""type"": ""state""}]"	train
Process performance The process performance reached steady state after approximately 6weeks of operation.	steady state,52,64,state	"[{""token"": ""steady state"", ""start_span"": 52, ""end_span"": 64, ""type"": ""state""}]"	train
It consists of many fluid outlets building a carbonate plateau.	carbonate,45,54,state	"[{""token"": ""carbonate"", ""start_span"": 45, ""end_span"": 54, ""type"": ""state""}]"	train
Upon detection of a positive HIV - 1 RNA test result, the participants underwent blood collection and pelvic examinations with CVL sample collection at 1, 2, 3, 5, 9, 12, 24, 36, and 48weeks postdetection.	positive HIV - 1,20,36,state	"[{""token"": ""positive HIV - 1"", ""start_span"": 20, ""end_span"": 36, ""type"": ""state""}]"	train
Mice were exposed to Antibiotic Mix ( ABX Mix), a combination of ampicillin ( Sigma - Aldrich; Cat # A0166), metronidazole ( Sigma - Aldrich; Cat # M1547), neomycin ( Sigma - Aldrich; Cat # N6386), and vancomycin ( Sigma - Aldrich; Cat # V1130), each at 1 g / L, in the drinking water or control ( untreated) water.	untreated,298,307,state	"[{""token"": ""untreated"", ""start_span"": 298, ""end_span"": 307, ""type"": ""state""}]"	train
"Experimental Procedures Sampling and measurement of physicochemical parameters Mat samples were collected in March 2012 in a small pond of the salar de Llamara, at the North of the Atacama desert ( 2116 ' 7. 37 "" S, 6937 ' 4. 01 "" W)."	small,125,130,state	"[{""token"": ""small"", ""start_span"": 125, ""end_span"": 130, ""type"": ""state""}]"	train
This inoculum was used to run sequential batch bottles fed with untreated and steam - exploded birch.	sequential batch,30,46,state	"[{""token"": ""sequential batch"", ""start_span"": 30, ""end_span"": 46, ""type"": ""state""}]"	train
Atorvastatin ( Pfizer Inc., USA) was used as a cholesterol - lowering drug47.	cholesterol,47,58,state	"[{""token"": ""cholesterol"", ""start_span"": 47, ""end_span"": 58, ""type"": ""state""}]"	train
Enzymatic assays were carried out using human recombinant PTP1B and p - nitrophenylphosphate ( pNPP) as reference substrate.	PTP1B,58,63,state	"[{""token"": ""PTP1B"", ""start_span"": 58, ""end_span"": 63, ""type"": ""state""}]"	train
Cultures were monitored by measuring CO depletion and methane, hydrogen and acetate production.	CO depletion,37,49,state	"[{""token"": ""CO depletion"", ""start_span"": 37, ""end_span"": 49, ""type"": ""state""}]"	train
The concentration of sulfide ( S2) in the methanogenic effluents was determined using a NANOCOLOR SULFID 3 kit ( Macherey - Nagel) according to the method DIN 38405 - D26 / 27.	methanogenic,42,54,state	"[{""token"": ""methanogenic"", ""start_span"": 42, ""end_span"": 54, ""type"": ""state""}]"	train
For methane sampling, 3 ml of water close to the sediment surface ( < 1 cm) was taken with a 20 ml syringe mounted with a long PVC tube, and 2 ml of sediment was collected with cut - off plastic syringes.	methane,4,11,state	"[{""token"": ""methane"", ""start_span"": 4, ""end_span"": 11, ""type"": ""state""}]"	train
The lakes are fish - and cladoceran - free ( Sommaruga and Kandolf, 2014;	fish - and cladoceran - free,14,42,state	"[{""token"": ""fish - and cladoceran - free"", ""start_span"": 14, ""end_span"": 42, ""type"": ""state""}]"	train
All fasting treefrogs were then transferred into an incubator kept in constant darkness.	fasting,4,11,state	"[{""token"": ""fasting"", ""start_span"": 4, ""end_span"": 11, ""type"": ""state""}]"	train
Mesophilic temperature conditions were maintained with a Pt - 1000 temperature sensor and a heater.	Mesophilic temperature,0,22,state	"[{""token"": ""Mesophilic temperature"", ""start_span"": 0, ""end_span"": 22, ""type"": ""state""}]"	train
All patients were advised to keep brushing their teeth exclusively with the originally provided toothpaste.	patients,4,12,state	"[{""token"": ""patients"", ""start_span"": 4, ""end_span"": 12, ""type"": ""state""}]"	train
Reactors were covered with aluminum foil to avoid light exposure.	avoid light exposure,44,64,state	"[{""token"": ""avoid light exposure"", ""start_span"": 44, ""end_span"": 64, ""type"": ""state""}]"	train
The average temperature is 7C with extreme maximum and minimum temperature of 35. 6C and 31. 5C.	average temperature is 7C,4,29,state	"[{""token"": ""average temperature is 7C"", ""start_span"": 4, ""end_span"": 29, ""type"": ""state""}]"	train
Mice were examined daily for signs of paralysis.	paralysis,38,47,state	"[{""token"": ""paralysis"", ""start_span"": 38, ""end_span"": 47, ""type"": ""state""}]"	train
Subsequently, mRNA transcripts were mapped against all ORFs to identify functions that were highly expressed by the community during steady - state bioreactor operation ( Supplementary Data 2).	steady - state,133,147,state	"[{""token"": ""steady - state"", ""start_span"": 133, ""end_span"": 147, ""type"": ""state""}]"	train
The presence of hydrogenotrophic methanogens in the inoculum improves methane gas production in microbial electrolysis cells High current densities in microbial electrolysis cells ( MECs) result from the predominance of various Geobacter species on the anode, but it is not known if archaeal communities similarly converge to one specific genus.	hydrogenotrophic,16,32,state	"[{""token"": ""hydrogenotrophic"", ""start_span"": 16, ""end_span"": 32, ""type"": ""state""}]"	train
Dams were maintained on a high - fat diet ( HFD) consisting of 36% fat ( from porcine and poultry fat, corn and fish oil; TAD Primate Diet 5LOP, Test Diet, St. Louis, MO) that is supplemented with calorically dense treats ( consisting of Glaxo powder / TAD pellets, peanut butter, honey, banana, and cornstarch).	Dams,0,4,state	"[{""token"": ""Dams"", ""start_span"": 0, ""end_span"": 4, ""type"": ""state""}]"	train
Foliar P concentrations were measured by inductively coupled plasma optical emission spectrometry ( ICP - OES, Thermo Elemental Iris Intrepid II XDL, Franklin, USA) after a microwave - assisted digestion with HNO3: H2O2 ( 4: 1, v: v) at the Ionomics facility at CEBAS - CSIC.	Foliar P concentrations,0,23,state	"[{""token"": ""Foliar P concentrations"", ""start_span"": 0, ""end_span"": 23, ""type"": ""state""}]"	train
To associate larvae with a specific bacterial strain, sterile diet ( without antibiotics) was amended with an aliquot of an overnight culture to a final concentration of 103 CFU ml - 1.	larvae,13,19,state	"[{""token"": ""larvae"", ""start_span"": 13, ""end_span"": 19, ""type"": ""state""}]"	train
On day 50 ( denoted by the asterisk) of the 75 - day synbiotic supplementation period the majority juveniles stools ( n = 5) were observed to return to normal.	normal,152,158,state	"[{""token"": ""normal"", ""start_span"": 152, ""end_span"": 158, ""type"": ""state""}]"	train
Ankle thickness was measured daily after bacterial gavage and tissues were collected 10 days after bacterial challenge for flow cytometry analysis.	Ankle thickness,0,15,state	"[{""token"": ""Ankle thickness"", ""start_span"": 0, ""end_span"": 15, ""type"": ""state""}]"	train
The hyperalkaline springs within the Murcilago watershed are located at the bottom portion of the catchment ( 78 m a. s. l.).	hyperalkaline,4,17,state	"[{""token"": ""hyperalkaline"", ""start_span"": 4, ""end_span"": 17, ""type"": ""state""}]"	train
Bound and total phenols.	phenols,16,23,state	"[{""token"": ""phenols"", ""start_span"": 16, ""end_span"": 23, ""type"": ""state""}]"	train
Table 1CharacteristicAll participants ( N = 87) Age ( years) 32. 0 ( 25. 039. 0) Age at sexual debut ( years) 18. 0 ( 16. 019. 0) Number of lifetime sexual partners3. 0 ( 2. 04. 0) Number of sex acts with study partner in last month4. 0 ( 2. 08. 0) Currently on hormonal contraception *	Currently on hormonal contraception,249,284,state	"[{""token"": ""Currently on hormonal contraception"", ""start_span"": 249, ""end_span"": 284, ""type"": ""state""}]"	train
New evidences on the altered gut microbiota in autism spectrum disorders Background Autism spectrum disorders ( ASDs) are neurodevelopmental conditions characterized by social and behavioural impairments.	autism,47,53,state	"[{""token"": ""autism"", ""start_span"": 47, ""end_span"": 53, ""type"": ""state""}]"	train
The women were enrolled in the FRESH study, a prospective observational study conducted near Durban, South Africa ( 19).	women,4,9,state	"[{""token"": ""women"", ""start_span"": 4, ""end_span"": 9, ""type"": ""state""}]"	train
Briefly, a water kefir simulation medium containing unrefined cane sugar ( 7. 1%, m / v) and fig extract ( 17. 6%, v / v) was used for the water kefir fermentations.	fermentations,151,164,state	"[{""token"": ""fermentations"", ""start_span"": 151, ""end_span"": 164, ""type"": ""state""}]"	train
Upper Gastrointestinal Endoscopy and Biopsy Procedures Before endoscopic examination, subjects were asked to score their symptoms from 0 ( none) to 5 ( very severe) on the 20 - item Patient Assessment of Gastrointestinal Disorders Symptom Severity Index ( PAGI - SYM) questionnaire, as described previously [ 16].	Gastrointestinal Disorders Symptom,204,238,state	"[{""token"": ""Gastrointestinal Disorders Symptom"", ""start_span"": 204, ""end_span"": 238, ""type"": ""state""}]"	train
